countyFIPS,Estimate!!EMPLOYMENT STATUS!!Population 16 years and over,Percent Estimate!!EMPLOYMENT STATUS!!Population 16 years and over,Estimate!!EMPLOYMENT STATUS!!Population 16 years and over!!In labor force,Percent Estimate!!EMPLOYMENT STATUS!!Population 16 years and over!!In labor force,Estimate!!EMPLOYMENT STATUS!!Population 16 years and over!!In labor force!!Civilian labor force,Percent Estimate!!EMPLOYMENT STATUS!!Population 16 years and over!!In labor force!!Civilian labor force,Estimate!!EMPLOYMENT STATUS!!Population 16 years and over!!In labor force!!Civilian labor force!!Employed,Percent Estimate!!EMPLOYMENT STATUS!!Population 16 years and over!!In labor force!!Civilian labor force!!Employed,Estimate!!EMPLOYMENT STATUS!!Population 16 years and over!!In labor force!!Civilian labor force!!Unemployed,Percent Estimate!!EMPLOYMENT STATUS!!Population 16 years and over!!In labor force!!Civilian labor force!!Unemployed,Estimate!!EMPLOYMENT STATUS!!Population 16 years and over!!In labor force!!Armed Forces,Percent Estimate!!EMPLOYMENT STATUS!!Population 16 years and over!!In labor force!!Armed Forces,Estimate!!EMPLOYMENT STATUS!!Population 16 years and over!!Not in labor force,Percent Estimate!!EMPLOYMENT STATUS!!Population 16 years and over!!Not in labor force,Estimate!!EMPLOYMENT STATUS!!Civilian labor force,Percent Estimate!!EMPLOYMENT STATUS!!Civilian labor force,Estimate!!EMPLOYMENT STATUS!!Civilian labor force!!Unemployment Rate,Percent Estimate!!EMPLOYMENT STATUS!!Civilian labor force!!Unemployment Rate,Estimate!!EMPLOYMENT STATUS!!Females 16 years and over,Percent Estimate!!EMPLOYMENT STATUS!!Females 16 years and over,Estimate!!EMPLOYMENT STATUS!!Females 16 years and over!!In labor force,Percent Estimate!!EMPLOYMENT STATUS!!Females 16 years and over!!In labor force,Estimate!!EMPLOYMENT STATUS!!Females 16 years and over!!In labor force!!Civilian labor force,Percent Estimate!!EMPLOYMENT STATUS!!Females 16 years and over!!In labor force!!Civilian labor force,Estimate!!EMPLOYMENT STATUS!!Females 16 years and over!!In labor force!!Civilian labor force!!Employed,Percent Estimate!!EMPLOYMENT STATUS!!Females 16 years and over!!In labor force!!Civilian labor force!!Employed,Estimate!!EMPLOYMENT STATUS!!Own children of the householder under 6 years,Percent Estimate!!EMPLOYMENT STATUS!!Own children of the householder under 6 years,Estimate!!EMPLOYMENT STATUS!!Own children of the householder under 6 years!!All parents in family in labor force,Percent Estimate!!EMPLOYMENT STATUS!!Own children of the householder under 6 years!!All parents in family in labor force,Estimate!!EMPLOYMENT STATUS!!Own children of the householder 6 to 17 years,Percent Estimate!!EMPLOYMENT STATUS!!Own children of the householder 6 to 17 years,Estimate!!EMPLOYMENT STATUS!!Own children of the householder 6 to 17 years!!All parents in family in labor force,Percent Estimate!!EMPLOYMENT STATUS!!Own children of the householder 6 to 17 years!!All parents in family in labor force
1001,43368,43368,25736,59.3,25189,58.1,24124,55.6,1065,2.5,547,1.3,17632,40.7,25189,25189,(X),4.2,22458,22458,11709,52.1,11661,51.9,11263,50.2,3777,3777,2025,53.6,8961,8961,6176,68.9
1003,167712,167712,98030,58.5,97722,58.3,93379,55.7,4343,2.6,308,0.2,69682,41.5,97722,97722,(X),4.4,86912,86912,47115,54.2,47045,54.1,45096,51.9,13362,13362,8128,60.8,29987,29987,22021,73.4
1005,20948,20948,9638,46.0,9638,46.0,8720,41.6,918,4.4,0,0.0,11310,54.0,9638,9638,(X),9.5,9764,9764,4533,46.4,4533,46.4,4104,42.0,1557,1557,809,52.0,3416,3416,2227,65.2
1007,18470,18470,8757,47.4,8757,47.4,8099,43.8,658,3.6,0,0.0,9713,52.6,8757,8757,(X),7.5,8546,8546,3995,46.7,3995,46.7,3635,42.5,1511,1511,837,55.4,2887,2887,2054,71.1
1009,45915,45915,22306,48.6,22255,48.5,21346,46.5,909,2.0,51,0.1,23609,51.4,22255,22255,(X),4.1,23360,23360,9789,41.9,9771,41.8,9304,39.8,3821,3821,2127,55.7,8851,8851,4568,51.6
1011,8413,8413,4430,52.7,4430,52.7,3940,46.8,490,5.8,0,0.0,3983,47.3,4430,4430,(X),11.1,3754,3754,1791,47.7,1791,47.7,1663,44.3,608,608,270,44.4,1348,1348,715,53.0
1013,15970,15970,8464,53.0,8452,52.9,7885,49.4,567,3.6,12,0.1,7506,47.0,8452,8452,(X),6.7,8729,8729,4464,51.1,4457,51.1,4196,48.1,1387,1387,1101,79.4,2828,2828,2283,80.7
1015,93023,93023,53078,57.1,52785,56.7,48157,51.8,4628,5.0,293,0.3,39945,42.9,52785,52785,(X),8.8,48908,48908,25387,51.9,25379,51.9,22809,46.6,7615,7615,4891,64.2,15251,15251,10906,71.5
1017,27656,27656,15571,56.3,15559,56.3,14786,53.5,773,2.8,12,0.0,12085,43.7,15559,15559,(X),5.0,14570,14570,7377,50.6,7365,50.5,7052,48.4,2055,2055,1433,69.7,4218,4218,3193,75.7
1019,21349,21349,10386,48.6,10386,48.6,9805,45.9,581,2.7,0,0.0,10963,51.4,10386,10386,(X),5.6,10784,10784,4440,41.2,4440,41.2,4283,39.7,1287,1287,984,76.5,3645,3645,2385,65.4
1021,34516,34516,18836,54.6,18836,54.6,17500,50.7,1336,3.9,0,0.0,15680,45.4,18836,18836,(X),7.1,17604,17604,8374,47.6,8374,47.6,7963,45.2,3089,3089,1769,57.3,6890,6890,4628,67.2
1023,10800,10800,4768,44.1,4768,44.1,4264,39.5,504,4.7,0,0.0,6032,55.9,4768,4768,(X),10.6,5721,5721,2133,37.3,2133,37.3,1951,34.1,646,646,330,51.1,1722,1722,746,43.3
1025,19763,19763,8941,45.2,8930,45.2,7647,38.7,1283,6.5,11,0.1,10822,54.8,8930,8930,(X),14.4,10542,10542,3818,36.2,3818,36.2,3169,30.1,1448,1448,799,55.2,3470,3470,2286,65.9
1027,10843,10843,5920,54.6,5920,54.6,5542,51.1,378,3.5,0,0.0,4923,45.4,5920,5920,(X),6.4,5665,5665,2823,49.8,2823,49.8,2664,47.0,691,691,502,72.6,1945,1945,1314,67.6
1029,11847,11847,6108,51.6,6086,51.4,5628,47.5,458,3.9,22,0.2,5739,48.4,6086,6086,(X),7.5,6149,6149,2699,43.9,2699,43.9,2535,41.2,913,913,505,55.3,2090,2090,1364,65.3
1031,40510,40510,24240,59.8,23096,57.0,21725,53.6,1371,3.4,1144,2.8,16270,40.2,23096,23096,(X),5.9,20716,20716,11038,53.3,10952,52.9,10315,49.8,3364,3364,2436,72.4,7743,7743,5457,70.5
1033,44328,44328,23880,53.9,23833,53.8,22436,50.6,1397,3.2,47,0.1,20448,46.1,23833,23833,(X),5.9,23324,23324,11320,48.5,11320,48.5,10824,46.4,3514,3514,2186,62.2,7229,7229,5173,71.6
1035,10152,10152,4397,43.3,4397,43.3,3892,38.3,505,5.0,0,0.0,5755,56.7,4397,4397,(X),11.5,5357,5357,2061,38.5,2061,38.5,1874,35.0,739,739,454,61.4,1743,1743,887,50.9
1037,9227,9227,4363,47.3,4363,47.3,4110,44.5,253,2.7,0,0.0,4864,52.7,4363,4363,(X),5.8,4589,4589,2090,45.5,2090,45.5,2001,43.6,430,430,303,70.5,1240,1240,807,65.1
1039,30107,30107,16348,54.3,16327,54.2,14899,49.5,1428,4.7,21,0.1,13759,45.7,16327,16327,(X),8.7,15801,15801,7442,47.1,7432,47.0,6768,42.8,2481,2481,1706,68.8,4818,4818,3229,67.0
1041,11106,11106,6006,54.1,5959,53.7,5612,50.5,347,3.1,47,0.4,5100,45.9,5959,5959,(X),5.8,5770,5770,2688,46.6,2688,46.6,2533,43.9,832,832,558,67.1,1977,1977,1365,69.0
1043,65879,65879,34955,53.1,34906,53.0,33003,50.1,1903,2.9,49,0.1,30924,46.9,34906,34906,(X),5.5,33694,33694,15584,46.3,15575,46.2,14741,43.7,5455,5455,3347,61.4,11880,11880,7712,64.9
1045,39028,39028,22131,56.7,19763,50.6,18025,46.2,1738,4.5,2368,6.1,16897,43.3,19763,19763,(X),8.8,20034,20034,9789,48.9,9482,47.3,8548,42.7,3658,3658,2093,57.2,7144,7144,4805,67.3
1047,31400,31400,16213,51.6,16201,51.6,14295,45.5,1906,6.1,12,0.0,15187,48.4,16201,16201,(X),11.8,17357,17357,8286,47.7,8274,47.7,7271,41.9,2884,2884,1758,61.0,6098,6098,4262,69.9
1049,55947,55947,29993,53.6,29988,53.6,28637,51.2,1351,2.4,5,0.0,25954,46.4,29988,29988,(X),4.5,28458,28458,13070,45.9,13070,45.9,12409,43.6,4927,4927,3252,66.0,10918,10918,6818,62.4
1051,65199,65199,36488,56.0,36030,55.3,33811,51.9,2219,3.4,458,0.7,28711,44.0,36030,36030,(X),6.2,33955,33955,18391,54.2,18290,53.9,17122,50.4,5488,5488,3838,69.9,12087,12087,8657,71.6
1053,29981,29981,14077,47.0,14077,47.0,12182,40.6,1895,6.3,0,0.0,15904,53.0,14077,14077,(X),13.5,14580,14580,6660,45.7,6660,45.7,5695,39.1,2389,2389,1683,70.4,4956,4956,3259,65.8
1055,83391,83391,45330,54.4,45312,54.3,42367,50.8,2945,3.5,18,0.0,38061,45.6,45312,45312,(X),6.5,43580,43580,21380,49.1,21371,49.0,20111,46.1,6135,6135,3756,61.2,14152,14152,9097,64.3
1057,13491,13491,6876,51.0,6863,50.9,6380,47.3,483,3.6,13,0.1,6615,49.0,6863,6863,(X),7.0,7038,7038,3111,44.2,3111,44.2,2871,40.8,1040,1040,682,65.6,2243,2243,1393,62.1
1059,24598,24598,13691,55.7,13689,55.7,12849,52.2,840,3.4,2,0.0,10907,44.3,13689,13689,(X),6.1,12536,12536,5766,46.0,5766,46.0,5358,42.7,2350,2350,1418,60.3,4799,4799,2945,61.4
1061,21376,21376,11081,51.8,10992,51.4,10047,47.0,945,4.4,89,0.4,10295,48.2,10992,10992,(X),8.6,11055,11055,4990,45.1,4977,45.0,4526,40.9,1516,1516,895,59.0,3792,3792,2593,68.4
1063,6661,6661,2619,39.3,2619,39.3,2204,33.1,415,6.2,0,0.0,4042,60.7,2619,2619,(X),15.8,3586,3586,1316,36.7,1316,36.7,1173,32.7,610,610,488,80.0,1095,1095,623,56.9
1065,11857,11857,5813,49.0,5769,48.7,5083,42.9,686,5.8,44,0.4,6044,51.0,5769,5769,(X),11.9,6403,6403,2913,45.5,2913,45.5,2613,40.8,1048,1048,656,62.6,2003,2003,1505,75.1
1067,13980,13980,7372,52.7,7362,52.7,6868,49.1,494,3.5,10,0.1,6608,47.3,7362,7362,(X),6.7,7305,7305,3634,49.7,3634,49.7,3437,47.0,1077,1077,724,67.2,2124,2124,1585,74.6
1069,82833,82833,47797,57.7,47645,57.5,44291,53.5,3354,4.0,152,0.2,35036,42.3,47645,47645,(X),7.0,43917,43917,22884,52.1,22874,52.1,21323,48.6,7390,7390,4914,66.5,15415,15415,10989,71.3
1071,42344,42344,21471,50.7,21466,50.7,20189,47.7,1277,3.0,5,0.0,20873,49.3,21466,21466,(X),5.9,21961,21961,9643,43.9,9643,43.9,9110,41.5,2934,2934,1388,47.3,7382,7382,4059,55.0
1073,525347,525347,326611,62.2,326091,62.1,302428,57.6,23663,4.5,520,0.1,198736,37.8,326091,326091,(X),7.3,281586,281586,163138,57.9,163025,57.9,150704,53.5,47794,47794,34564,72.3,93472,93472,68992,73.8
1075,11160,11160,5803,52.0,5803,52.0,5338,47.8,465,4.2,0,0.0,5357,48.0,5803,5803,(X),8.0,5791,5791,2474,42.7,2474,42.7,2222,38.4,762,762,442,58.0,2016,2016,1248,61.9
1077,76107,76107,42473,55.8,42397,55.7,40130,52.7,2267,3.0,76,0.1,33634,44.2,42397,42397,(X),5.3,40202,40202,20205,50.3,20205,50.3,18997,47.3,5397,5397,3340,61.9,12186,12186,8139,66.8
1079,26741,26741,13353,49.9,13334,49.9,12568,47.0,766,2.9,19,0.1,13388,50.1,13334,13334,(X),5.7,13814,13814,5693,41.2,5685,41.2,5403,39.1,2200,2200,1153,52.4,4657,4657,2406,51.7
1081,128804,128804,78041,60.6,77367,60.1,72956,56.6,4411,3.4,674,0.5,50763,39.4,77367,77367,(X),5.7,66170,66170,36857,55.7,36806,55.6,34559,52.2,11039,11039,7186,65.1,21122,21122,15150,71.7
1083,74268,74268,42646,57.4,42552,57.3,39595,53.3,2957,4.0,94,0.1,31622,42.6,42552,42552,(X),6.9,37118,37118,19129,51.5,19129,51.5,17594,47.4,6121,6121,3969,64.8,14474,14474,9354,64.6
1085,8097,8097,3907,48.3,3907,48.3,3457,42.7,450,5.6,0,0.0,4190,51.7,3907,3907,(X),11.5,4294,4294,2017,47.0,2017,47.0,1786,41.6,707,707,390,55.2,1382,1382,695,50.3
1087,16058,16058,8309,51.7,8295,51.7,7289,45.4,1006,6.3,14,0.1,7749,48.3,8295,8295,(X),12.1,8799,8799,4360,49.6,4346,49.4,3822,43.4,992,992,653,65.8,2019,2019,1624,80.4
1089,287944,287944,184407,64.0,183263,63.6,172631,60.0,10632,3.7,1144,0.4,103537,36.0,183263,183263,(X),5.8,148505,148505,85790,57.8,85622,57.7,80267,54.1,24149,24149,15544,64.4,51027,51027,35847,70.3
1091,15703,15703,7269,46.3,7269,46.3,6563,41.8,706,4.5,0,0.0,8434,53.7,7269,7269,(X),9.7,8399,8399,3511,41.8,3511,41.8,3137,37.3,1122,1122,559,49.8,2833,2833,2149,75.9
1093,24333,24333,12710,52.2,12688,52.1,11980,49.2,708,2.9,22,0.1,11623,47.8,12688,12688,(X),5.6,12453,12453,5878,47.2,5878,47.2,5570,44.7,1640,1640,1062,64.8,4024,4024,2618,65.1
1095,74128,74128,41119,55.5,41088,55.4,38997,52.6,2091,2.8,31,0.0,33009,44.5,41088,41088,(X),5.1,37927,37927,18143,47.8,18143,47.8,17314,45.7,7109,7109,3712,52.2,14684,14684,9707,66.1
1097,327952,327952,186507,56.9,185743,56.6,174229,53.1,11514,3.5,764,0.2,141445,43.1,185743,185743,(X),6.2,173805,173805,92069,53.0,91987,52.9,86613,49.8,29965,29965,19367,64.6,61699,61699,42680,69.2
1099,17132,17132,7781,45.4,7781,45.4,6422,37.5,1359,7.9,0,0.0,9351,54.6,7781,7781,(X),17.5,9273,9273,3852,41.5,3852,41.5,3129,33.7,1451,1451,1004,69.2,2771,2771,1916,69.1
1101,179544,179544,110586,61.6,108842,60.6,100599,56.0,8243,4.6,1744,1.0,68958,38.4,108842,108842,(X),7.6,96238,96238,55528,57.7,55246,57.4,51232,53.2,17213,17213,12284,71.4,32714,32714,23374,71.4
1103,94987,94987,54363,57.2,54328,57.2,51513,54.2,2815,3.0,35,0.0,40624,42.8,54328,54328,(X),5.2,48615,48615,24936,51.3,24936,51.3,23614,48.6,7959,7959,5345,67.2,17528,17528,11592,66.1
1105,7699,7699,2658,34.5,2651,34.4,2325,30.2,326,4.2,7,0.1,5041,65.5,2651,2651,(X),12.3,4158,4158,1514,36.4,1514,36.4,1291,31.0,562,562,344,61.2,1372,1372,803,58.5
1107,16837,16837,7978,47.4,7978,47.4,7136,42.4,842,5.0,0,0.0,8859,52.6,7978,7978,(X),10.6,8925,8925,3284,36.8,3284,36.8,2975,33.3,1096,1096,756,69.0,2522,2522,1707,67.7
1109,27676,27676,15325,55.4,15319,55.4,14093,50.9,1226,4.4,6,0.0,12351,44.6,15319,15319,(X),8.0,14623,14623,7502,51.3,7496,51.3,6760,46.2,2109,2109,1236,58.6,4036,4036,2822,69.9
1111,18218,18218,9079,49.8,9079,49.8,8628,47.4,451,2.5,0,0.0,9139,50.2,9079,9079,(X),5.0,9495,9495,4153,43.7,4153,43.7,4013,42.3,1490,1490,938,63.0,3152,3152,1834,58.2
1113,45527,45527,26795,58.9,25550,56.1,23550,51.7,2000,4.4,1245,2.7,18732,41.1,25550,25550,(X),7.8,23793,23793,12832,53.9,12780,53.7,11686,49.1,4909,4909,3483,71.0,7980,7980,5570,69.8
1115,69474,69474,41104,59.2,41069,59.1,38881,56.0,2188,3.1,35,0.1,28370,40.8,41069,41069,(X),5.3,34978,34978,19385,55.4,19385,55.4,18357,52.5,6180,6180,3884,62.8,12815,12815,8833,68.9
1117,166663,166663,110274,66.2,110135,66.1,105724,63.4,4411,2.6,139,0.1,56389,33.8,110135,110135,(X),4.0,86796,86796,51582,59.4,51571,59.4,49451,57.0,14365,14365,9139,63.6,34110,34110,24131,70.7
1119,10765,10765,4799,44.6,4787,44.5,4207,39.1,580,5.4,12,0.1,5966,55.4,4787,4787,(X),12.1,5906,5906,2469,41.8,2469,41.8,2116,35.8,762,762,467,61.3,1591,1591,1008,63.4
1121,65443,65443,34131,52.2,34086,52.1,31082,47.5,3004,4.6,45,0.1,31312,47.8,34086,34086,(X),8.8,33977,33977,16801,49.4,16793,49.4,15458,45.5,4936,4936,3263,66.1,10959,10959,7527,68.7
1123,33023,33023,16838,51.0,16838,51.0,15083,45.7,1755,5.3,0,0.0,16185,49.0,16838,16838,(X),10.4,17202,17202,7921,46.0,7921,46.0,7111,41.3,2659,2659,1493,56.1,5351,5351,3218,60.1
1125,167611,167611,99830,59.6,99707,59.5,93450,55.8,6257,3.7,123,0.1,67781,40.4,99707,99707,(X),6.3,87737,87737,48811,55.6,48756,55.6,45713,52.1,14353,14353,9329,65.0,26552,26552,19269,72.6
1127,51826,51826,27108,52.3,27082,52.3,24707,47.7,2375,4.6,26,0.1,24718,47.7,27082,27082,(X),8.8,26858,26858,12443,46.3,12426,46.3,11208,41.7,4297,4297,2801,65.2,8848,8848,5708,64.5
1129,13563,13563,6055,44.6,6055,44.6,5538,40.8,517,3.8,0,0.0,7508,55.4,6055,6055,(X),8.5,6694,6694,2602,38.9,2602,38.9,2360,35.3,685,685,397,58.0,2457,2457,1516,61.7
1131,8573,8573,3437,40.1,3412,39.8,2882,33.6,530,6.2,25,0.3,5136,59.9,3412,3412,(X),15.5,4543,4543,1756,38.7,1756,38.7,1457,32.1,569,569,305,53.6,1471,1471,855,58.1
1133,19505,19505,9758,50.0,9740,49.9,9000,46.1,740,3.8,18,0.1,9747,50.0,9740,9740,(X),7.6,9897,9897,4262,43.1,4262,43.1,3851,38.9,1293,1293,696,53.8,3335,3335,2430,72.9
2013,3003,3003,2486,82.8,2482,82.7,2395,79.8,87,2.9,4,0.1,517,17.2,2482,2482,(X),3.5,1237,1237,968,78.3,968,78.3,927,74.9,126,126,88,69.8,338,338,313,92.6
2016,4878,4878,4028,82.6,3968,81.3,3889,79.7,79,1.6,60,1.2,850,17.4,3968,3968,(X),2.0,1857,1857,1327,71.5,1326,71.4,1288,69.4,270,270,171,63.3,600,600,467,77.8
2020,230429,230429,167429,72.7,159183,69.1,150201,65.2,8982,3.9,8246,3.6,63000,27.3,159183,159183,(X),5.6,113006,113006,76166,67.4,75045,66.4,71416,63.2,25537,25537,16317,63.9,43839,43839,31816,72.6
2050,12230,12230,7567,61.9,7559,61.8,6178,50.5,1381,11.3,8,0.1,4663,38.1,7559,7559,(X),18.3,5848,5848,3536,60.5,3533,60.4,2987,51.1,2127,2127,1350,63.5,3743,3743,2449,65.4
2060,720,720,544,75.6,531,73.8,488,67.8,43,6.0,13,1.8,176,24.4,531,531,(X),8.1,279,279,208,74.6,206,73.8,194,69.5,55,55,48,87.3,119,119,104,87.4
2068,2011,2011,1566,77.9,1523,75.7,1478,73.5,45,2.2,43,2.1,445,22.1,1523,1523,(X),3.0,1040,1040,771,74.1,755,72.6,724,69.6,50,50,11,22.0,184,184,106,57.6
2070,3602,3602,2298,63.8,2298,63.8,2024,56.2,274,7.6,0,0.0,1304,36.2,2298,2298,(X),11.9,1693,1693,1111,65.6,1111,65.6,1009,59.6,537,537,328,61.1,834,834,503,60.3
2090,77606,77606,56476,72.8,50069,64.5,46543,60.0,3526,4.5,6407,8.3,21130,27.2,50069,50069,(X),7.0,35092,35092,23367,66.6,22845,65.1,21396,61.0,9026,9026,5258,58.3,13838,13838,9335,67.5
2100,2008,2008,1380,68.7,1380,68.7,1329,66.2,51,2.5,0,0.0,628,31.3,1380,1380,(X),3.7,923,923,599,64.9,599,64.9,593,64.2,161,161,156,96.9,362,362,342,94.5
2105,1827,1827,1203,65.8,1198,65.6,1068,58.5,130,7.1,5,0.3,624,34.2,1198,1198,(X),10.9,856,856,547,63.9,547,63.9,496,57.9,129,129,108,83.7,187,187,127,67.9
2110,26168,26168,18944,72.4,18634,71.2,17562,67.1,1072,4.1,310,1.2,7224,27.6,18634,18634,(X),5.8,12835,12835,8958,69.8,8925,69.5,8503,66.2,2296,2296,1608,70.0,4383,4383,3487,79.6
2122,46420,46420,27880,60.1,27740,59.8,25564,55.1,2176,4.7,140,0.3,18540,39.9,27740,27740,(X),7.8,22088,22088,12646,57.3,12646,57.3,11863,53.7,4142,4142,2544,61.4,8614,8614,5665,65.8
2130,11024,11024,7714,70.0,7516,68.2,7017,63.7,499,4.5,198,1.8,3310,30.0,7516,7516,(X),6.6,5334,5334,3542,66.4,3515,65.9,3316,62.2,933,933,653,70.0,1923,1923,1466,76.2
2150,10417,10417,7880,75.6,7300,70.1,6919,66.4,381,3.7,580,5.6,2537,24.4,7300,7300,(X),5.2,4870,4870,3470,71.3,3398,69.8,3318,68.1,1350,1350,993,73.6,2108,2108,1708,81.0
2158,5184,5184,2945,56.8,2937,56.7,2088,40.3,849,16.4,8,0.2,2239,43.2,2937,2937,(X),28.9,2389,2389,1251,52.4,1251,52.4,981,41.1,1203,1203,725,60.3,1895,1895,1151,60.7
2164,1056,1056,705,66.8,705,66.8,594,56.3,111,10.5,0,0.0,351,33.2,705,705,(X),15.7,481,481,320,66.5,320,66.5,275,57.2,99,99,71,71.7,232,232,154,66.4
2170,78437,78437,48118,61.3,47536,60.6,43000,54.8,4536,5.8,582,0.7,30319,38.7,47536,47536,(X),9.5,37420,37420,20787,55.6,20745,55.4,18666,49.9,8416,8416,3940,46.8,18157,18157,10315,56.8
2180,6886,6886,4442,64.5,4397,63.9,3664,53.2,733,10.6,45,0.7,2444,35.5,4397,4397,(X),16.7,3203,3203,2109,65.8,2101,65.6,1822,56.9,1062,1062,720,67.8,2026,2026,1497,73.9
2185,7530,7530,6049,80.3,6004,79.7,5465,72.6,539,7.2,45,0.6,1481,19.7,6004,6004,(X),9.0,2616,2616,1849,70.7,1849,70.7,1688,64.5,912,912,658,72.1,1397,1397,949,67.9
2188,5279,5279,3241,61.4,3241,61.4,2636,49.9,605,11.5,0,0.0,2038,38.6,3241,3241,(X),18.7,2390,2390,1397,58.5,1397,58.5,1191,49.8,934,934,546,58.5,1556,1556,1036,66.6
2195,2597,2597,1657,63.8,1647,63.4,1577,60.7,70,2.7,10,0.4,940,36.2,1647,1647,(X),4.3,1262,1262,790,62.6,789,62.5,770,61.0,241,241,175,72.6,461,461,323,70.1
2198,5099,5099,3174,62.2,3174,62.2,2789,54.7,385,7.6,0,0.0,1925,37.8,3174,3174,(X),12.1,2301,2301,1420,61.7,1420,61.7,1291,56.1,457,457,313,68.5,897,897,598,66.7
2220,7058,7058,5045,71.5,4962,70.3,4746,67.2,216,3.1,83,1.2,2013,28.5,4962,4962,(X),4.4,3474,3474,2377,68.4,2377,68.4,2302,66.3,436,436,326,74.8,1270,1270,1067,84.0
2230,904,904,746,82.5,746,82.5,695,76.9,51,5.6,0,0.0,158,17.5,746,746,(X),6.8,417,417,332,79.6,332,79.6,310,74.3,68,68,53,77.9,106,106,99,93.4
2240,5186,5186,3354,64.7,3226,62.2,2896,55.8,330,6.4,128,2.5,1832,35.3,3226,3226,(X),10.2,2238,2238,1263,56.4,1261,56.3,1154,51.6,526,526,353,67.1,1215,1215,744,61.2
2261,7289,7289,5278,72.4,5079,69.7,4744,65.1,335,4.6,199,2.7,2011,27.6,5079,5079,(X),6.6,3389,3389,2332,68.8,2289,67.5,2218,65.4,615,615,247,40.2,1520,1520,1198,78.8
2275,2070,2070,1195,57.7,1195,57.7,1128,54.5,67,3.2,0,0.0,875,42.3,1195,1195,(X),5.6,976,976,534,54.7,534,54.7,504,51.6,111,111,83,74.8,338,338,234,69.2
2282,518,518,380,73.4,380,73.4,357,68.9,23,4.4,0,0.0,138,26.6,380,380,(X),6.1,222,222,158,71.2,158,71.2,149,67.1,66,66,35,53.0,116,116,75,64.7
2290,4092,4092,2629,64.2,2609,63.8,2118,51.8,491,12.0,20,0.5,1463,35.8,2609,2609,(X),18.8,1869,1869,1200,64.2,1200,64.2,1041,55.7,480,480,347,72.3,894,894,710,79.4
4001,54045,54045,20871,38.6,20870,38.6,18365,34.0,2505,4.6,1,0.0,33174,61.4,20870,20870,(X),12.0,27389,27389,10671,39.0,10671,39.0,9587,35.0,5368,5368,2262,42.1,12577,12577,6876,54.7
4003,101377,101377,50142,49.5,46439,45.8,43097,42.5,3342,3.3,3703,3.7,51235,50.5,46439,46439,(X),7.2,49854,49854,22735,45.6,21974,44.1,20435,41.0,8919,8919,4611,51.7,17129,17129,10355,60.5
4005,114113,114113,71820,62.9,71700,62.8,66310,58.1,5390,4.7,120,0.1,42293,37.1,71700,71700,(X),7.5,58357,58357,35514,60.9,35470,60.8,32931,56.4,8870,8870,5955,67.1,18504,18504,13075,70.7
4007,43569,43569,20214,46.4,20214,46.4,18162,41.7,2052,4.7,0,0.0,23355,53.6,20214,20214,(X),10.2,22227,22227,9656,43.4,9656,43.4,8706,39.2,3392,3392,2276,67.1,6105,6105,3681,60.3
4009,28750,28750,14166,49.3,14166,49.3,12837,44.7,1329,4.6,0,0.0,14584,50.7,14166,14166,(X),9.4,13044,13044,6751,51.8,6751,51.8,6207,47.6,3066,3066,1659,54.1,6295,6295,4060,64.5
4011,7125,7125,4094,57.5,4094,57.5,3812,53.5,282,4.0,0,0.0,3031,42.5,4094,4094,(X),6.9,3396,3396,1556,45.8,1556,45.8,1364,40.2,788,788,310,39.3,1576,1576,813,51.6
4012,17724,17724,7028,39.7,7028,39.7,6466,36.5,562,3.2,0,0.0,10696,60.3,7028,7028,(X),8.0,8621,8621,3162,36.7,3162,36.7,2848,33.0,936,936,588,62.8,2094,2094,1473,70.3
4013,3329961,3329961,2126196,63.9,2121295,63.7,2004236,60.2,117059,3.5,4901,0.1,1203765,36.1,2121295,2121295,(X),5.5,1697121,1697121,979841,57.7,978962,57.7,926264,54.6,320337,320337,196836,61.4,668322,668322,445836,66.7
4015,173770,173770,78204,45.0,78198,45.0,71244,41.0,6954,4.0,6,0.0,95566,55.0,78198,78198,(X),8.9,86085,86085,37362,43.4,37356,43.4,34423,40.0,10180,10180,6679,65.6,23405,23405,15721,67.2
4017,82143,82143,39063,47.6,39063,47.6,33272,40.5,5791,7.0,0,0.0,43080,52.4,39063,39063,(X),14.8,41159,41159,18856,45.8,18856,45.8,16468,40.0,8779,8779,4344,49.5,18220,18220,10432,57.3
4019,826613,826613,482546,58.4,476815,57.7,440596,53.3,36219,4.4,5731,0.7,344067,41.6,476815,476815,(X),7.6,423539,423539,229161,54.1,228094,53.9,209827,49.5,66963,66963,43516,65.0,138276,138276,98787,71.4
4021,332316,332316,163268,49.1,163079,49.1,150294,45.2,12785,3.8,189,0.1,169048,50.9,163079,163079,(X),7.8,157690,157690,76200,48.3,76179,48.3,70517,44.7,28687,28687,17628,61.4,63158,63158,41109,65.1
4023,35433,35433,18821,53.1,18798,53.1,17233,48.6,1565,4.4,23,0.1,16612,46.9,18798,18798,(X),8.3,18774,18774,8796,46.9,8796,46.9,7778,41.4,3811,3811,2120,55.6,8570,8570,5557,64.8
4025,191513,191513,90283,47.1,90218,47.1,84142,43.9,6076,3.2,65,0.0,101230,52.9,90218,90218,(X),6.7,98539,98539,42862,43.5,42862,43.5,40024,40.6,10926,10926,5940,54.4,23989,23989,15517,64.7
4027,160374,160374,87810,54.8,84215,52.5,75912,47.3,8303,5.2,3595,2.2,72564,45.2,84215,84215,(X),9.9,77614,77614,36012,46.4,35819,46.2,32000,41.2,16831,16831,9459,56.2,33557,33557,22188,66.1
5001,14579,14579,8316,57.0,8316,57.0,7796,53.5,520,3.6,0,0.0,6263,43.0,8316,8316,(X),6.3,7598,7598,4155,54.7,4155,54.7,3920,51.6,1450,1450,1034,71.3,2272,2272,1506,66.3
5003,16167,16167,8301,51.3,8301,51.3,7728,47.8,573,3.5,0,0.0,7866,48.7,8301,8301,(X),6.9,8453,8453,3988,47.2,3988,47.2,3641,43.1,1254,1254,622,49.6,3057,3057,1970,64.4
5005,34881,34881,16968,48.6,16968,48.6,16232,46.5,736,2.1,0,0.0,17913,51.4,16968,16968,(X),4.3,18169,18169,8573,47.2,8573,47.2,8204,45.2,1829,1829,1189,65.0,4390,4390,2941,67.0
5007,197430,197430,128941,65.3,128841,65.3,125343,63.5,3498,1.8,100,0.1,68489,34.7,128841,128841,(X),2.7,100523,100523,58284,58.0,58284,58.0,56752,56.5,21735,21735,13554,62.4,45335,45335,31040,68.5
5009,29661,29661,16892,57.0,16885,56.9,16145,54.4,740,2.5,7,0.0,12769,43.0,16885,16885,(X),4.4,15172,15172,7875,51.9,7875,51.9,7534,49.7,2728,2728,1594,58.4,4975,4975,3731,75.0
5011,8592,8592,4577,53.3,4577,53.3,4209,49.0,368,4.3,0,0.0,4015,46.7,4577,4577,(X),8.0,4524,4524,2126,47.0,2126,47.0,1894,41.9,690,690,430,62.3,1706,1706,1079,63.2
5013,4292,4292,2296,53.5,2296,53.5,2155,50.2,141,3.3,0,0.0,1996,46.5,2296,2296,(X),6.1,2137,2137,985,46.1,985,46.1,924,43.2,352,352,219,62.2,679,679,424,62.4
5015,22412,22412,12458,55.6,12457,55.6,11867,52.9,590,2.6,1,0.0,9954,44.4,12457,12457,(X),4.7,11372,11372,5630,49.5,5630,49.5,5350,47.0,1708,1708,1104,64.6,4123,4123,3028,73.4
5017,8637,8637,3971,46.0,3968,45.9,3583,41.5,385,4.5,3,0.0,4666,54.0,3968,3968,(X),9.7,4406,4406,2031,46.1,2031,46.1,1855,42.1,732,732,504,68.9,1565,1565,1135,72.5
5019,18620,18620,10774,57.9,10765,57.8,10475,56.3,290,1.6,9,0.0,7846,42.1,10765,10765,(X),2.7,9951,9951,5233,52.6,5233,52.6,5141,51.7,1310,1310,724,55.3,2707,2707,1789,66.1
5021,12104,12104,6581,54.4,6581,54.4,6249,51.6,332,2.7,0,0.0,5523,45.6,6581,6581,(X),5.0,6185,6185,3099,50.1,3099,50.1,3027,48.9,961,961,686,71.4,2160,2160,1618,74.9
5023,21054,21054,10737,51.0,10737,51.0,10235,48.6,502,2.4,0,0.0,10317,49.0,10737,10737,(X),4.7,10775,10775,4732,43.9,4732,43.9,4506,41.8,1417,1417,790,55.8,3108,3108,2067,66.5
5025,6583,6583,3425,52.0,3417,51.9,3230,49.1,187,2.8,8,0.1,3158,48.0,3417,3417,(X),5.5,3361,3361,1588,47.2,1580,47.0,1498,44.6,466,466,368,79.0,1270,1270,748,58.9
5027,19563,19563,10544,53.9,10544,53.9,9469,48.4,1075,5.5,0,0.0,9019,46.1,10544,10544,(X),10.2,10381,10381,5215,50.2,5215,50.2,4824,46.5,1612,1612,1210,75.1,2890,2890,1961,67.9
5029,16512,16512,9438,57.2,9429,57.1,8870,53.7,559,3.4,9,0.1,7074,42.8,9429,9429,(X),5.9,8532,8532,4671,54.7,4662,54.6,4420,51.8,1407,1407,968,68.8,3018,3018,2429,80.5
5031,82418,82418,51903,63.0,51843,62.9,48814,59.2,3029,3.7,60,0.1,30515,37.0,51843,51843,(X),5.8,43025,43025,24782,57.6,24750,57.5,23184,53.9,8000,8000,5985,74.8,16402,16402,11738,71.6
5033,48792,48792,27479,56.3,27371,56.1,25985,53.3,1386,2.8,108,0.2,21313,43.7,27371,27371,(X),5.1,24937,24937,12392,49.7,12392,49.7,11895,47.7,4190,4190,2420,57.8,10254,10254,6357,62.0
5035,37033,37033,22525,60.8,22525,60.8,20402,55.1,2123,5.7,0,0.0,14508,39.2,22525,22525,(X),9.4,19885,19885,11494,57.8,11494,57.8,10299,51.8,4334,4334,3017,69.6,8098,8098,6196,76.5
5037,13439,13439,7974,59.3,7974,59.3,7516,55.9,458,3.4,0,0.0,5465,40.7,7974,7974,(X),5.7,7088,7088,3827,54.0,3827,54.0,3628,51.2,1170,1170,814,69.6,2496,2496,1805,72.3
5039,6013,6013,3096,51.5,3096,51.5,2944,49.0,152,2.5,0,0.0,2917,48.5,3096,3096,(X),4.9,3147,3147,1508,47.9,1508,47.9,1457,46.3,419,419,358,85.4,747,747,563,75.4
5041,9212,9212,4959,53.8,4959,53.8,4426,48.0,533,5.8,0,0.0,4253,46.2,4959,4959,(X),10.7,4983,4983,2394,48.0,2394,48.0,2088,41.9,768,768,564,73.4,1950,1950,1222,62.7
5043,14954,14954,8315,55.6,8304,55.5,7825,52.3,479,3.2,11,0.1,6639,44.4,8304,8304,(X),5.8,7809,7809,4299,55.1,4299,55.1,4060,52.0,1261,1261,895,71.0,2423,2423,1892,78.1
5045,96793,96793,60303,62.3,60044,62.0,57226,59.1,2818,2.9,259,0.3,36490,37.7,60044,60044,(X),4.7,50029,50029,28362,56.7,28265,56.5,27011,54.0,9260,9260,5979,64.6,17967,17967,13139,73.1
5047,14171,14171,7004,49.4,6986,49.3,6773,47.8,213,1.5,18,0.1,7167,50.6,6986,6986,(X),3.0,7260,7260,3515,48.4,3515,48.4,3455,47.6,1173,1173,771,65.7,2795,2795,1645,58.9
5049,9914,9914,4329,43.7,4329,43.7,4045,40.8,284,2.9,0,0.0,5585,56.3,4329,4329,(X),6.6,4991,4991,2084,41.8,2084,41.8,1967,39.4,598,598,335,56.0,1552,1552,863,55.6
5051,80534,80534,43378,53.9,43378,53.9,40302,50.0,3076,3.8,0,0.0,37156,46.1,43378,43378,(X),7.1,42268,42268,20952,49.6,20952,49.6,19648,46.5,6040,6040,3857,63.9,12372,12372,8553,69.1
5053,14497,14497,8183,56.4,8173,56.4,7594,52.4,579,4.0,10,0.1,6314,43.6,8173,8173,(X),7.1,7383,7383,3767,51.0,3767,51.0,3533,47.9,1145,1145,838,73.2,2686,2686,1740,64.8
5055,34974,34974,20393,58.3,20391,58.3,18971,54.2,1420,4.1,2,0.0,14581,41.7,20391,20391,(X),7.0,17879,17879,9152,51.2,9152,51.2,8560,47.9,3362,3362,2268,67.5,6653,6653,4712,70.8
5057,16885,16885,9352,55.4,9352,55.4,8834,52.3,518,3.1,0,0.0,7533,44.6,9352,9352,(X),5.5,8878,8878,4489,50.6,4489,50.6,4241,47.8,1705,1705,1114,65.3,3633,3633,2313,63.7
5059,27356,27356,14311,52.3,14301,52.3,13232,48.4,1069,3.9,10,0.0,13045,47.7,14301,14301,(X),7.5,13196,13196,6416,48.6,6416,48.6,6129,46.4,1889,1889,1328,70.3,4474,4474,3267,73.0
5061,10289,10289,5938,57.7,5938,57.7,5559,54.0,379,3.7,0,0.0,4351,42.3,5938,5938,(X),6.4,5391,5391,2816,52.2,2816,52.2,2589,48.0,1115,1115,636,57.0,2217,2217,1634,73.7
5063,29311,29311,16340,55.7,16340,55.7,15547,53.0,793,2.7,0,0.0,12971,44.3,16340,16340,(X),4.9,15221,15221,7503,49.3,7503,49.3,7062,46.4,2729,2729,1514,55.5,5025,5025,3713,73.9
5065,11357,11357,5135,45.2,5130,45.2,4654,41.0,476,4.2,5,0.0,6222,54.8,5130,5130,(X),9.3,5431,5431,2438,44.9,2438,44.9,2360,43.5,729,729,548,75.2,1573,1573,993,63.1
5067,14128,14128,5959,42.2,5959,42.2,5563,39.4,396,2.8,0,0.0,8169,57.8,5959,5959,(X),6.6,7220,7220,2224,30.8,2224,30.8,2065,28.6,1062,1062,644,60.6,2076,2076,1106,53.3
5069,56399,56399,28940,51.3,28935,51.3,26047,46.2,2888,5.1,5,0.0,27459,48.7,28935,28935,(X),10.0,28719,28719,15315,53.3,15315,53.3,13822,48.1,4980,4980,3494,70.2,9515,9515,6895,72.5
5071,20534,20534,10808,52.6,10804,52.6,10363,50.5,441,2.1,4,0.0,9726,47.4,10804,10804,(X),4.1,10402,10402,4934,47.4,4934,47.4,4813,46.3,2007,2007,1305,65.0,4092,4092,2543,62.1
5073,5727,5727,2793,48.8,2793,48.8,2630,45.9,163,2.8,0,0.0,2934,51.2,2793,2793,(X),5.8,2995,2995,1337,44.6,1337,44.6,1248,41.7,442,442,221,50.0,745,745,446,59.9
5075,13391,13391,7126,53.2,7126,53.2,6613,49.4,513,3.8,0,0.0,6265,46.8,7126,7126,(X),7.2,6841,6841,3307,48.3,3307,48.3,3093,45.2,1001,1001,536,53.5,2419,2419,1558,64.4
5077,7895,7895,3196,40.5,3196,40.5,2708,34.3,488,6.2,0,0.0,4699,59.5,3196,3196,(X),15.3,3365,3365,1459,43.4,1459,43.4,1157,34.4,532,532,331,62.2,958,958,610,63.7
5079,11608,11608,3488,30.0,3488,30.0,3366,29.0,122,1.1,0,0.0,8120,70.0,3488,3488,(X),3.5,4079,4079,1874,45.9,1874,45.9,1858,45.6,617,617,371,60.1,1543,1543,922,59.8
5081,9983,9983,5386,54.0,5386,54.0,4804,48.1,582,5.8,0,0.0,4597,46.0,5386,5386,(X),10.8,5307,5307,2631,49.6,2631,49.6,2494,47.0,769,769,515,67.0,1670,1670,1056,63.2
5083,17549,17549,9572,54.5,9560,54.5,8723,49.7,837,4.8,12,0.1,7977,45.5,9560,9560,(X),8.8,8982,8982,4679,52.1,4668,52.0,4229,47.1,1435,1435,846,59.0,2942,2942,1815,61.7
5085,55508,55508,34604,62.3,33753,60.8,32335,58.3,1418,2.6,851,1.5,20904,37.7,33753,33753,(X),4.2,28620,28620,15869,55.4,15841,55.3,15325,53.5,5589,5589,3673,65.7,12169,12169,8601,70.7
5087,12857,12857,7038,54.7,7021,54.6,6574,51.1,447,3.5,17,0.1,5819,45.3,7021,7021,(X),6.4,6473,6473,3144,48.6,3127,48.3,2941,45.4,1141,1141,698,61.2,2377,2377,1347,56.7
5089,13755,13755,5777,42.0,5777,42.0,5322,38.7,455,3.3,0,0.0,7978,58.0,5777,5777,(X),7.9,7046,7046,2835,40.2,2835,40.2,2652,37.6,837,837,532,63.6,1980,1980,1348,68.1
5091,34695,34695,19153,55.2,19153,55.2,17600,50.7,1553,4.5,0,0.0,15542,44.8,19153,19153,(X),8.1,17873,17873,8957,50.1,8957,50.1,8234,46.1,3157,3157,2201,69.7,6323,6323,4223,66.8
5093,32924,32924,19118,58.1,19118,58.1,17337,52.7,1781,5.4,0,0.0,13806,41.9,19118,19118,(X),9.3,17215,17215,9352,54.3,9352,54.3,8294,48.2,3437,3437,2436,70.9,6723,6723,4636,69.0
5095,5951,5951,3202,53.8,3202,53.8,2984,50.1,218,3.7,0,0.0,2749,46.2,3202,3202,(X),6.8,3204,3204,1664,51.9,1664,51.9,1566,48.9,536,536,385,71.8,839,839,664,79.1
5097,7504,7504,3481,46.4,3481,46.4,3284,43.8,197,2.6,0,0.0,4023,53.6,3481,3481,(X),5.7,3845,3845,1453,37.8,1453,37.8,1378,35.8,489,489,292,59.7,1069,1069,609,57.0
5099,6716,6716,3337,49.7,3337,49.7,3151,46.9,186,2.8,0,0.0,3379,50.3,3337,3337,(X),5.6,3435,3435,1532,44.6,1532,44.6,1491,43.4,560,560,383,68.4,1025,1025,696,67.9
5101,6484,6484,3142,48.5,3142,48.5,3080,47.5,62,1.0,0,0.0,3342,51.5,3142,3142,(X),2.0,3298,3298,1522,46.1,1522,46.1,1516,46.0,439,439,379,86.3,967,967,803,83.0
5103,19156,19156,10608,55.4,10608,55.4,9839,51.4,769,4.0,0,0.0,8548,44.6,10608,10608,(X),7.2,10255,10255,5398,52.6,5398,52.6,5046,49.2,1547,1547,916,59.2,3566,3566,2668,74.8
5105,8220,8220,4041,49.2,4038,49.1,3763,45.8,275,3.3,3,0.0,4179,50.8,4038,4038,(X),6.8,4088,4088,1846,45.2,1846,45.2,1702,41.6,613,613,436,71.1,1599,1599,990,61.9
5107,14594,14594,7652,52.4,7652,52.4,6851,46.9,801,5.5,0,0.0,6942,47.6,7652,7652,(X),10.5,8004,8004,4061,50.7,4061,50.7,3594,44.9,1336,1336,923,69.1,3117,3117,2218,71.2
5109,8691,8691,4764,54.8,4764,54.8,4548,52.3,216,2.5,0,0.0,3927,45.2,4764,4764,(X),4.5,4407,4407,2124,48.2,2124,48.2,1995,45.3,715,715,428,59.9,1493,1493,866,58.0
5111,19017,19017,10136,53.3,10136,53.3,9539,50.2,597,3.1,0,0.0,8881,46.7,10136,10136,(X),5.9,9890,9890,4645,47.0,4645,47.0,4326,43.7,1607,1607,964,60.0,3249,3249,1943,59.8
5113,16070,16070,8017,49.9,8017,49.9,7292,45.4,725,4.5,0,0.0,8053,50.1,8017,8017,(X),9.0,8227,8227,3736,45.4,3736,45.4,3518,42.8,1286,1286,730,56.8,3161,3161,2162,68.4
5115,50692,50692,28929,57.1,28902,57.0,27105,53.5,1797,3.5,27,0.1,21763,42.9,28902,28902,(X),6.2,26009,26009,14065,54.1,14052,54.0,13091,50.3,4542,4542,2860,63.0,9216,9216,6400,69.4
5117,6766,6766,3700,54.7,3700,54.7,3465,51.2,235,3.5,0,0.0,3066,45.3,3700,3700,(X),6.4,3468,3468,1651,47.6,1651,47.6,1535,44.3,602,602,458,76.1,941,941,705,74.9
5119,310864,310864,196835,63.3,194471,62.6,184451,59.3,10020,3.2,2364,0.8,114029,36.7,194471,194471,(X),5.2,164450,164450,97129,59.1,96692,58.8,91787,55.8,30683,30683,19676,64.1,55892,55892,39933,71.4
5121,13913,13913,7131,51.3,7131,51.3,6831,49.1,300,2.2,0,0.0,6782,48.7,7131,7131,(X),4.2,7052,7052,2960,42.0,2960,42.0,2837,40.2,1125,1125,686,61.0,2418,2418,1485,61.4
5123,21205,21205,9449,44.6,9449,44.6,8697,41.0,752,3.5,0,0.0,11756,55.4,9449,9449,(X),8.0,9303,9303,4383,47.1,4383,47.1,4059,43.6,1840,1840,1134,61.6,3425,3425,2439,71.2
5125,93508,93508,58741,62.8,58672,62.7,56382,60.3,2290,2.4,69,0.1,34767,37.2,58672,58672,(X),3.9,47961,47961,28017,58.4,28007,58.4,26878,56.0,8172,8172,5646,69.1,18079,18079,14089,77.9
5127,8059,8059,4196,52.1,4196,52.1,3763,46.7,433,5.4,0,0.0,3863,47.9,4196,4196,(X),10.3,3978,3978,2215,55.7,2215,55.7,1986,49.9,936,936,738,78.8,1654,1654,1085,65.6
5129,6517,6517,3227,49.5,3227,49.5,3129,48.0,98,1.5,0,0.0,3290,50.5,3227,3227,(X),3.0,3293,3293,1472,44.7,1472,44.7,1414,42.9,451,451,299,66.3,1063,1063,653,61.4
5131,100052,100052,59904,59.9,59831,59.8,56926,56.9,2905,2.9,73,0.1,40148,40.1,59831,59831,(X),4.9,51743,51743,27880,53.9,27871,53.9,26694,51.6,9114,9114,5782,63.4,19805,19805,12614,63.7
5133,12853,12853,7907,61.5,7907,61.5,7498,58.3,409,3.2,0,0.0,4946,38.5,7907,7907,(X),5.2,6407,6407,3510,54.8,3510,54.8,3325,51.9,1622,1622,1123,69.2,3176,3176,2006,63.2
5135,13807,13807,6182,44.8,6182,44.8,5871,42.5,311,2.3,0,0.0,7625,55.2,6182,6182,(X),5.0,7068,7068,2755,39.0,2755,39.0,2654,37.5,886,886,511,57.7,2409,2409,1544,64.1
5137,10303,10303,4848,47.1,4848,47.1,4540,44.1,308,3.0,0,0.0,5455,52.9,4848,4848,(X),6.4,5226,5226,1990,38.1,1990,38.1,1853,35.5,690,690,451,65.4,1613,1613,1045,64.8
5139,31098,31098,17059,54.9,17059,54.9,15821,50.9,1238,4.0,0,0.0,14039,45.1,17059,17059,(X),7.3,16112,16112,8127,50.4,8127,50.4,7652,47.5,2680,2680,1575,58.8,6174,6174,4367,70.7
5141,13692,13692,6114,44.7,6114,44.7,5675,41.4,439,3.2,0,0.0,7578,55.3,6114,6114,(X),7.2,6917,6917,2747,39.7,2747,39.7,2559,37.0,856,856,543,63.4,2305,2305,1299,56.4
5143,177873,177873,115203,64.8,115108,64.7,110021,61.9,5087,2.9,95,0.1,62670,35.2,115108,115108,(X),4.4,89620,89620,51924,57.9,51924,57.9,49958,55.7,19006,19006,11971,63.0,35677,35677,25417,71.2
5145,62339,62339,34157,54.8,33993,54.5,32028,51.4,1965,3.2,164,0.3,28182,45.2,33993,33993,(X),5.8,32172,32172,15982,49.7,15982,49.7,15066,46.8,5528,5528,3380,61.1,11730,11730,7428,63.3
5147,5383,5383,2774,51.5,2774,51.5,2526,46.9,248,4.6,0,0.0,2609,48.5,2774,2774,(X),8.9,2884,2884,1352,46.9,1352,46.9,1172,40.6,347,347,252,72.6,903,903,716,79.3
5149,16799,16799,9529,56.7,9511,56.6,8983,53.5,528,3.1,18,0.1,7270,43.3,9511,9511,(X),5.6,8472,8472,4344,51.3,4344,51.3,4099,48.4,1605,1605,933,58.1,3550,3550,2672,75.3
6001,1335756,1335756,893607,66.9,892280,66.8,847170,63.4,45110,3.4,1327,0.1,442149,33.1,892280,892280,(X),5.1,685810,685810,417753,60.9,417527,60.9,396197,57.8,114564,114564,73872,64.5,217114,217114,151697,69.9
6003,934,934,445,47.6,445,47.6,366,39.2,79,8.5,0,0.0,489,52.4,445,445,(X),17.8,440,440,195,44.3,195,44.3,171,38.9,34,34,18,52.9,169,169,125,74.0
6005,32677,32677,14576,44.6,14544,44.5,13289,40.7,1255,3.8,32,0.1,18101,55.4,14544,14544,(X),8.6,14965,14965,6915,46.2,6915,46.2,6465,43.2,1863,1863,1066,57.2,3549,3549,2204,62.1
6007,186682,186682,104083,55.8,103993,55.7,94908,50.8,9085,4.9,90,0.0,82599,44.2,103993,103993,(X),8.7,94919,94919,49576,52.2,49575,52.2,45510,47.9,14672,14672,9233,62.9,28041,28041,18730,66.8
6009,38555,38555,18263,47.4,18230,47.3,17114,44.4,1116,2.9,33,0.1,20292,52.6,18230,18230,(X),6.1,19410,19410,8742,45.0,8742,45.0,8345,43.0,2171,2171,1017,46.8,5043,5043,3612,71.6
6011,16229,16229,10199,62.8,10183,62.7,9663,59.5,520,3.2,16,0.1,6030,37.2,10183,10183,(X),5.1,7855,7855,4244,54.0,4244,54.0,3955,50.4,1865,1865,1153,61.8,3904,3904,2729,69.9
6013,902257,902257,583611,64.7,582886,64.6,547323,60.7,35563,3.9,725,0.1,318646,35.3,582886,582886,(X),6.1,466420,466420,273484,58.6,273399,58.6,256706,55.0,76371,76371,48778,63.9,174427,174427,115844,66.4
6015,22005,22005,9632,43.8,9619,43.7,8823,40.1,796,3.6,13,0.1,12373,56.2,9619,9619,(X),8.3,10150,10150,4771,47.0,4771,47.0,4533,44.7,1814,1814,1153,63.6,3630,3630,2009,55.3
6017,153562,153562,88853,57.9,88529,57.7,83049,54.1,5480,3.6,324,0.2,64709,42.1,88529,88529,(X),6.2,77575,77575,41347,53.3,41289,53.2,39204,50.5,9902,9902,6393,64.6,26346,26346,18225,69.2
6019,727089,727089,442178,60.8,441451,60.7,400175,55.0,41276,5.7,727,0.1,284911,39.2,441451,441451,(X),9.4,367446,367446,201819,54.9,201693,54.9,181292,49.3,90688,90688,54155,59.7,175608,175608,114272,65.1
6021,21351,21351,11812,55.3,11800,55.3,10994,51.5,806,3.8,12,0.1,9539,44.7,11800,11800,(X),6.8,10708,10708,5049,47.2,5049,47.2,4661,43.5,2112,2112,1243,58.9,4977,4977,2896,58.2
6023,112208,112208,66356,59.1,66297,59.1,60970,54.3,5327,4.7,59,0.1,45852,40.9,66297,66297,(X),8.0,56485,56485,32404,57.4,32401,57.4,29944,53.0,8682,8682,5533,63.7,16197,16197,11717,72.3
6025,133957,133957,71089,53.1,70701,52.8,59919,44.7,10782,8.0,388,0.3,62868,46.9,70701,70701,(X),15.3,65219,65219,33733,51.7,33677,51.6,28972,44.4,17417,17417,11232,64.5,31447,31447,20642,65.6
6027,14865,14865,8537,57.4,8537,57.4,8090,54.4,447,3.0,0,0.0,6328,42.6,8537,8537,(X),5.2,7404,7404,4031,54.4,4031,54.4,3882,52.4,1080,1080,761,70.5,2365,2365,1822,77.0
6029,652959,652959,380151,58.2,378440,58.0,339384,52.0,39056,6.0,1711,0.3,272808,41.8,378440,378440,(X),10.3,316912,316912,165444,52.2,165217,52.1,147654,46.6,81439,81439,47997,58.9,163273,163273,103072,63.1
6031,113475,113475,62193,54.8,58072,51.2,53217,46.9,4855,4.3,4121,3.6,51282,45.2,58072,58072,(X),8.4,49482,49482,26203,53.0,25450,51.4,23148,46.8,13239,13239,8155,61.6,25885,25885,16094,62.2
6033,52331,52331,26160,50.0,26145,50.0,23589,45.1,2556,4.9,15,0.0,26171,50.0,26145,26145,(X),9.8,26310,26310,12280,46.7,12280,46.7,11374,43.2,4144,4144,2722,65.7,8158,8158,5490,67.3
6035,26739,26739,9392,35.1,9358,35.0,8788,32.9,570,2.1,34,0.1,17347,64.9,9358,9358,(X),6.1,8374,8374,4211,50.3,4208,50.3,3987,47.6,1556,1556,828,53.2,3034,3034,1931,63.6
6037,8115158,8115158,5230394,64.5,5226836,64.4,4869658,60.0,357178,4.4,3558,0.0,2884764,35.5,5226836,5226836,(X),6.8,4152156,4152156,2404319,57.9,2403713,57.9,2234341,53.8,714736,714736,451629,63.2,1429769,1429769,942053,65.9
6039,117191,117191,63083,53.8,63042,53.8,57799,49.3,5243,4.5,41,0.0,54108,46.2,63042,63042,(X),8.3,61592,61592,29156,47.3,29156,47.3,26603,43.2,13726,13726,7664,55.8,27136,27136,16881,62.2
6041,212991,212991,136760,64.2,136574,64.1,131425,61.7,5149,2.4,186,0.1,76231,35.8,136574,136574,(X),3.8,109849,109849,64746,58.9,64714,58.9,62475,56.9,14642,14642,9396,64.2,36718,36718,25463,69.3
6043,15019,15019,7735,51.5,7727,51.4,7051,46.9,676,4.5,8,0.1,7284,48.5,7727,7727,(X),8.7,7433,7433,3570,48.0,3562,47.9,3217,43.3,881,881,494,56.1,1692,1692,1370,81.0
6045,71065,71065,41636,58.6,41549,58.5,37712,53.1,3837,5.4,87,0.1,29429,41.4,41549,41549,(X),9.2,35994,35994,19195,53.3,19195,53.3,17352,48.2,5830,5830,3571,61.3,11783,11783,8142,69.1
6047,197980,197980,117604,59.4,117550,59.4,102638,51.8,14912,7.5,54,0.0,80376,40.6,117550,117550,(X),12.7,98696,98696,50147,50.8,50147,50.8,43442,44.0,24844,24844,13621,54.8,51765,51765,31044,60.0
6049,7429,7429,3399,45.8,3399,45.8,3125,42.1,274,3.7,0,0.0,4030,54.2,3399,3399,(X),8.1,3642,3642,1697,46.6,1697,46.6,1657,45.5,454,454,268,59.0,1128,1128,698,61.9
6051,11803,11803,8626,73.1,8540,72.4,8278,70.1,262,2.2,86,0.7,3177,26.9,8540,8540,(X),3.1,5538,5538,3883,70.1,3879,70.0,3723,67.2,625,625,486,77.8,2044,2044,1362,66.6
6053,331250,331250,200871,60.6,195500,59.0,185025,55.9,10475,3.2,5371,1.6,130379,39.4,195500,195500,(X),5.4,162448,162448,88572,54.5,87226,53.7,82260,50.6,37761,37761,21136,56.0,71579,71579,44791,62.6
6055,114489,114489,74693,65.2,74616,65.2,70888,61.9,3728,3.3,77,0.1,39796,34.8,74616,74616,(X),5.0,57806,57806,34695,60.0,34688,60.0,33034,57.1,8429,8429,5861,69.5,20367,20367,15717,77.2
6057,84229,84229,46499,55.2,46339,55.0,43368,51.5,2971,3.5,160,0.2,37730,44.8,46339,46339,(X),6.4,42892,42892,21590,50.3,21551,50.2,20441,47.7,4897,4897,2900,59.2,11343,11343,7784,68.6
6059,2538090,2538090,1664072,65.6,1662510,65.5,1578079,62.2,84431,3.3,1562,0.1,874018,34.4,1662510,1662510,(X),5.1,1295841,1295841,757754,58.5,757504,58.5,719316,55.5,217330,217330,133412,61.4,465038,465038,303865,65.3
6061,304646,304646,183544,60.2,182498,59.9,173493,56.9,9005,3.0,1046,0.3,121102,39.8,182498,182498,(X),4.9,157750,157750,86489,54.8,86286,54.7,82387,52.2,24631,24631,15103,61.3,57920,57920,40449,69.8
6063,15985,15985,8052,50.4,8052,50.4,7536,47.1,516,3.2,0,0.0,7933,49.6,8052,8052,(X),6.4,8029,8029,3726,46.4,3726,46.4,3563,44.4,867,867,564,65.1,1904,1904,1519,79.8
6065,1842591,1842591,1106781,60.1,1102504,59.8,1007795,54.7,94709,5.1,4277,0.2,735810,39.9,1102504,1102504,(X),8.6,933106,933106,495280,53.1,494828,53.0,450272,48.3,182930,182930,106923,58.5,400951,400951,254497,63.5
6067,1186871,1186871,741831,62.5,740570,62.4,686019,57.8,54551,4.6,1261,0.1,445040,37.5,740570,740570,(X),7.4,613775,613775,356538,58.1,356314,58.1,330945,53.9,114375,114375,71142,62.2,231046,231046,157204,68.0
6069,45675,45675,31159,68.2,31125,68.1,28831,63.1,2294,5.0,34,0.1,14516,31.8,31125,31125,(X),7.4,22960,22960,14099,61.4,14099,61.4,12989,56.6,4492,4492,3090,68.8,10426,10426,8082,77.5
6071,1628558,1628558,989158,60.7,978082,60.1,892435,54.8,85647,5.3,11076,0.7,639400,39.3,978082,978082,(X),8.8,824729,824729,448917,54.4,448359,54.4,407876,49.5,175681,175681,103134,58.7,365151,365151,227137,62.2
6073,2656740,2656740,1745186,65.7,1671892,62.9,1564930,58.9,106962,4.0,73294,2.8,911554,34.3,1671892,1671892,(X),6.4,1325271,1325271,779825,58.8,771731,58.2,720972,54.4,243549,243549,150933,62.0,453531,453531,308242,68.0
6075,764514,764514,540964,70.8,540702,70.7,515382,67.4,25320,3.3,262,0.0,223550,29.2,540702,540702,(X),4.7,374685,374685,249860,66.7,249792,66.7,238905,63.8,45229,45229,32805,72.5,66722,66722,48966,73.4
6077,553741,553741,334903,60.5,334498,60.4,305509,55.2,28989,5.2,405,0.1,218838,39.5,334498,334498,(X),8.7,280523,280523,149985,53.5,149944,53.5,136699,48.7,61981,61981,36702,59.2,129696,129696,82158,63.3
6079,236821,236821,137399,58.0,135533,57.2,129358,54.6,6175,2.6,1866,0.8,99422,42.0,135533,135533,(X),4.6,116738,116738,63148,54.1,62619,53.6,59738,51.2,15095,15095,9844,65.2,33075,33075,23238,70.3
6081,622386,622386,427717,68.7,427467,68.7,409911,65.9,17556,2.8,250,0.0,194669,31.3,427467,427467,(X),4.1,317994,317994,200206,63.0,200192,63.0,192314,60.5,52889,52889,36889,69.7,102997,102997,74793,72.6
6083,355380,355380,227361,64.0,225612,63.5,211751,59.6,13861,3.9,1749,0.5,128019,36.0,225612,225612,(X),6.1,178104,178104,103856,58.3,103589,58.2,97270,54.6,31851,31851,20598,64.7,61597,61597,44245,71.8
6085,1537154,1537154,1036023,67.4,1035436,67.4,985838,64.1,49598,3.2,587,0.0,501131,32.6,1035436,1035436,(X),4.8,763265,763265,457967,60.0,457926,60.0,434876,57.0,137902,137902,86862,63.0,280203,280203,193799,69.2
6087,226263,226263,144081,63.7,143931,63.6,134904,59.6,9027,4.0,150,0.1,82182,36.3,143931,143931,(X),6.3,114934,114934,67556,58.8,67556,58.8,63380,55.1,16673,16673,10872,65.2,34536,34536,24240,70.2
6089,144873,144873,77237,53.3,77216,53.3,72392,50.0,4824,3.3,21,0.0,67636,46.7,77216,77216,(X),6.2,74470,74470,37238,50.0,37223,50.0,35225,47.3,11685,11685,6460,55.3,23594,23594,14796,62.7
6091,2540,2540,1311,51.6,1311,51.6,1251,49.3,60,2.4,0,0.0,1229,48.4,1311,1311,(X),4.6,1219,1219,654,53.7,654,53.7,634,52.0,112,112,79,70.5,329,329,245,74.5
6093,35851,35851,18191,50.7,18165,50.7,16725,46.7,1440,4.0,26,0.1,17660,49.3,18165,18165,(X),7.9,18081,18081,8789,48.6,8789,48.6,8121,44.9,2623,2623,1593,60.7,5499,5499,3772,68.6
6095,351136,351136,221803,63.2,218059,62.1,202713,57.7,15346,4.4,3744,1.1,129333,36.8,218059,218059,(X),7.0,177885,177885,104794,58.9,104101,58.5,97533,54.8,30591,30591,19513,63.8,62646,62646,44463,71.0
6097,412126,412126,267836,65.0,266964,64.8,253421,61.5,13543,3.3,872,0.2,144290,35.0,266964,266964,(X),5.1,212418,212418,127835,60.2,127712,60.1,121444,57.2,30434,30434,20270,66.6,65140,65140,45800,70.3
6099,408846,408846,248842,60.9,248662,60.8,222532,54.4,26130,6.4,180,0.0,160004,39.1,248662,248662,(X),10.5,208403,208403,110584,53.1,110573,53.1,98333,47.2,44954,44954,25946,57.7,94969,94969,61024,64.3
6101,73619,73619,43286,58.8,42808,58.1,38664,52.5,4144,5.6,478,0.6,30333,41.2,42808,42808,(X),9.7,37386,37386,19196,51.3,19096,51.1,17361,46.4,7518,7518,4283,57.0,16258,16258,10071,61.9
6103,50022,50022,26796,53.6,26749,53.5,24265,48.5,2484,5.0,47,0.1,23226,46.4,26749,26749,(X),9.3,25425,25425,12356,48.6,12356,48.6,11272,44.3,4324,4324,2784,64.4,9487,9487,6208,65.4
6105,11015,11015,5204,47.2,5204,47.2,4758,43.2,446,4.0,0,0.0,5811,52.8,5204,5204,(X),8.6,5409,5409,2429,44.9,2429,44.9,2243,41.5,625,625,321,51.4,1451,1451,1016,70.0
6107,332597,332597,195848,58.9,195557,58.8,177236,53.3,18321,5.5,291,0.1,136749,41.1,195557,195557,(X),9.4,167823,167823,84900,50.6,84859,50.6,76828,45.8,45567,45567,26389,57.9,91975,91975,58226,63.3
6109,46031,46031,22449,48.8,22446,48.8,20930,45.5,1516,3.3,3,0.0,23582,51.2,22446,22446,(X),6.8,22026,22026,10735,48.7,10735,48.7,10086,45.8,3143,3143,2012,64.0,5386,5386,3498,64.9
6111,672054,672054,441330,65.7,438081,65.2,412228,61.3,25853,3.8,3249,0.5,230724,34.3,438081,438081,(X),5.9,341586,341586,202501,59.3,202022,59.1,190225,55.7,59102,59102,39063,66.1,130539,130539,89769,68.8
6113,174246,174246,104244,59.8,104096,59.7,97374,55.9,6722,3.9,148,0.1,70002,40.2,104096,104096,(X),6.5,90291,90291,50395,55.8,50364,55.8,47255,52.3,14201,14201,9296,65.5,29966,29966,20587,68.7
6115,56589,56589,33246,58.7,31602,55.8,28954,51.2,2648,4.7,1644,2.9,23343,41.3,31602,31602,(X),8.4,28056,28056,14315,51.0,13968,49.8,12872,45.9,7096,7096,3780,53.3,12662,12662,7504,59.3
8001,375829,375829,267927,71.3,267457,71.2,255711,68.0,11746,3.1,470,0.1,107902,28.7,267457,267457,(X),4.4,187065,187065,121001,64.7,120846,64.6,115375,61.7,42592,42592,27758,65.2,86852,86852,60747,69.9
8003,12928,12928,7602,58.8,7602,58.8,6894,53.3,708,5.5,0,0.0,5326,41.2,7602,7602,(X),9.3,6519,6519,3518,54.0,3518,54.0,3200,49.1,1224,1224,771,63.0,2543,2543,1459,57.4
8005,500149,500149,357039,71.4,355395,71.1,339873,68.0,15522,3.1,1644,0.3,143110,28.6,355395,355395,(X),4.4,255661,255661,167443,65.5,167196,65.4,160015,62.6,48023,48023,32122,66.9,99304,99304,73233,73.7
8007,10884,10884,6185,56.8,6181,56.8,5823,53.5,358,3.3,4,0.0,4699,43.2,6181,6181,(X),5.8,5436,5436,2971,54.7,2971,54.7,2786,51.3,657,657,375,57.1,1503,1503,1141,75.9
8009,2919,2919,1673,57.3,1668,57.1,1627,55.7,41,1.4,5,0.2,1246,42.7,1668,1668,(X),2.5,1502,1502,762,50.7,762,50.7,748,49.8,242,242,87,36.0,449,449,296,65.9
8011,5013,5013,1645,32.8,1645,32.8,1526,30.4,119,2.4,0,0.0,3368,67.2,1645,1645,(X),7.2,1609,1609,742,46.1,742,46.1,681,42.3,227,227,172,75.8,606,606,373,61.6
8013,265772,265772,182396,68.6,182369,68.6,173653,65.3,8716,3.3,27,0.0,83376,31.4,182369,182369,(X),4.8,132904,132904,85368,64.2,85347,64.2,81759,61.5,17855,17855,11298,63.3,43011,43011,32039,74.5
8014,52250,52250,38195,73.1,38164,73.0,36792,70.4,1372,2.6,31,0.1,14055,26.9,38164,38164,(X),3.6,26470,26470,17942,67.8,17942,67.8,17289,65.3,4578,4578,3360,73.4,10939,10939,8399,76.8
8015,16506,16506,8920,54.0,8920,54.0,8674,52.6,246,1.5,0,0.0,7586,46.0,8920,8920,(X),2.8,7659,7659,4004,52.3,4004,52.3,3978,51.9,726,726,461,63.5,2170,2170,1437,66.2
8017,1423,1423,903,63.5,903,63.5,835,58.7,68,4.8,0,0.0,520,36.5,903,903,(X),7.5,727,727,398,54.7,398,54.7,378,52.0,241,241,117,48.5,416,416,312,75.0
8019,8144,8144,5389,66.2,5388,66.2,5287,64.9,101,1.2,1,0.0,2755,33.8,5388,5388,(X),1.9,3988,3988,2421,60.7,2421,60.7,2389,59.9,374,374,247,66.0,1077,1077,875,81.2
8021,6161,6161,3256,52.8,3256,52.8,2882,46.8,374,6.1,0,0.0,2905,47.2,3256,3256,(X),11.5,3063,3063,1368,44.7,1368,44.7,1186,38.7,634,634,367,57.9,1482,1482,960,64.8
8023,3119,3119,1448,46.4,1448,46.4,1287,41.3,161,5.2,0,0.0,1671,53.6,1448,1448,(X),11.1,1506,1506,603,40.0,603,40.0,537,35.7,148,148,138,93.2,381,381,266,69.8
8025,5005,5005,2185,43.7,2170,43.4,1821,36.4,349,7.0,15,0.3,2820,56.3,2170,2170,(X),16.1,1797,1797,936,52.1,936,52.1,858,47.7,199,199,117,58.8,507,507,335,66.1
8027,3919,3919,1503,38.4,1503,38.4,1405,35.9,98,2.5,0,0.0,2416,61.6,1503,1503,(X),6.5,1976,1976,584,29.6,584,29.6,542,27.4,143,143,34,23.8,564,564,208,36.9
8029,24876,24876,11922,47.9,11922,47.9,10912,43.9,1010,4.1,0,0.0,12954,52.1,11922,11922,(X),8.5,12368,12368,5501,44.5,5501,44.5,4983,40.3,1870,1870,692,37.0,4104,4104,2402,58.5
8031,565681,565681,405684,71.7,405269,71.6,389034,68.8,16235,2.9,415,0.1,159997,28.3,405269,405269,(X),4.0,283229,283229,188080,66.4,188000,66.4,180298,63.7,50271,50271,33182,66.0,83492,83492,57679,69.1
8033,1493,1493,864,57.9,864,57.9,855,57.3,9,0.6,0,0.0,629,42.1,864,864,(X),1.0,715,715,383,53.6,383,53.6,380,53.1,93,93,60,64.5,263,263,218,82.9
8035,249787,249787,182417,73.0,181993,72.9,176575,70.7,5418,2.2,424,0.2,67370,27.0,181993,181993,(X),3.0,126539,126539,83065,65.6,83000,65.6,80497,63.6,24366,24366,14586,59.9,63364,63364,44990,71.0
8037,43557,43557,34358,78.9,34335,78.8,33571,77.1,764,1.8,23,0.1,9199,21.1,34335,34335,(X),2.2,20458,20458,14736,72.0,14729,72.0,14464,70.7,3792,3792,2400,63.3,7620,7620,6084,79.8
8039,20263,20263,13861,68.4,13829,68.2,13449,66.4,380,1.9,32,0.2,6402,31.6,13829,13829,(X),2.7,10078,10078,6296,62.5,6283,62.3,6109,60.6,1374,1374,776,56.5,3794,3794,2576,67.9
8041,537548,537548,364071,67.7,334686,62.3,314102,58.4,20584,3.8,29385,5.5,173477,32.3,334686,334686,(X),6.2,266929,266929,161310,60.4,157040,58.8,146938,55.0,54196,54196,30805,56.8,108035,108035,71639,66.3
8043,40157,40157,15148,37.7,15101,37.6,14196,35.4,905,2.3,47,0.1,25009,62.3,15101,15101,(X),6.0,16253,16253,7653,47.1,7653,47.1,7309,45.0,2049,2049,1134,55.3,5098,5098,3048,59.8
8045,45135,45135,32807,72.7,32800,72.7,31397,69.6,1403,3.1,7,0.0,12328,27.3,32800,32800,(X),4.3,22203,22203,14432,65.0,14432,65.0,13863,62.4,4951,4951,2826,57.1,9573,9573,6529,68.2
8047,5065,5065,3733,73.7,3733,73.7,3645,72.0,88,1.7,0,0.0,1332,26.3,3733,3733,(X),2.4,2443,2443,1744,71.4,1744,71.4,1728,70.7,257,257,130,50.6,587,587,292,49.7
8049,12783,12783,9100,71.2,9100,71.2,8630,67.5,470,3.7,0,0.0,3683,28.8,9100,9100,(X),5.2,5887,5887,3917,66.5,3917,66.5,3660,62.2,717,717,574,80.1,1841,1841,1459,79.3
8051,14008,14008,10149,72.5,10149,72.5,9560,68.2,589,4.2,0,0.0,3859,27.5,10149,10149,(X),5.8,6382,6382,4406,69.0,4406,69.0,4231,66.3,929,929,731,78.7,1954,1954,1624,83.1
8053,754,754,420,55.7,420,55.7,404,53.6,16,2.1,0,0.0,334,44.3,420,420,(X),3.8,401,401,209,52.1,209,52.1,201,50.1,35,35,7,20.0,91,91,77,84.6
8055,5576,5576,2705,48.5,2705,48.5,2593,46.5,112,2.0,0,0.0,2871,51.5,2705,2705,(X),4.1,2784,2784,1204,43.2,1204,43.2,1145,41.1,231,231,152,65.8,709,709,514,72.5
8057,1056,1056,687,65.1,687,65.1,672,63.6,15,1.4,0,0.0,369,34.9,687,687,(X),2.2,531,531,290,54.6,290,54.6,282,53.1,97,97,27,27.8,150,150,93,62.0
8059,468288,468288,325060,69.4,324838,69.4,312767,66.8,12071,2.6,222,0.0,143228,30.6,324838,324838,(X),3.7,236709,236709,153090,64.7,153042,64.7,148137,62.6,34967,34967,23992,68.6,76274,76274,59307,77.8
8061,1082,1082,693,64.0,693,64.0,673,62.2,20,1.8,0,0.0,389,36.0,693,693,(X),2.9,568,568,320,56.3,320,56.3,311,54.8,149,149,92,61.7,223,223,162,72.6
8063,6025,6025,3771,62.6,3771,62.6,3587,59.5,184,3.1,0,0.0,2254,37.4,3771,3771,(X),4.9,2732,2732,1742,63.8,1742,63.8,1589,58.2,478,478,362,75.7,1273,1273,1124,88.3
8065,6524,6524,4373,67.0,4369,67.0,4129,63.3,240,3.7,4,0.1,2151,33.0,4369,4369,(X),5.5,2929,2929,1685,57.5,1685,57.5,1612,55.0,367,367,266,72.5,836,836,549,65.7
8067,45680,45680,30796,67.4,30796,67.4,29546,64.7,1250,2.7,0,0.0,14884,32.6,30796,30796,(X),4.1,22677,22677,14325,63.2,14325,63.2,13936,61.5,3178,3178,2033,64.0,6876,6876,4877,70.9
8069,278231,278231,187008,67.2,186774,67.1,177391,63.8,9383,3.4,234,0.1,91223,32.8,186774,186774,(X),5.0,140140,140140,87242,62.3,87193,62.2,83173,59.3,20595,20595,13527,65.7,44325,44325,32493,73.3
8071,11923,11923,6525,54.7,6521,54.7,6021,50.5,500,4.2,4,0.0,5398,45.3,6521,6521,(X),7.7,5641,5641,2972,52.7,2968,52.6,2718,48.2,689,689,423,61.4,1518,1518,1107,72.9
8073,4575,4575,1576,34.4,1576,34.4,1529,33.4,47,1.0,0,0.0,2999,65.6,1576,1576,(X),3.0,1619,1619,980,60.5,980,60.5,959,59.2,387,387,282,72.9,692,692,579,83.7
8075,17547,17547,11152,63.6,11152,63.6,10690,60.9,462,2.6,0,0.0,6395,36.4,11152,11152,(X),4.1,7875,7875,4610,58.5,4610,58.5,4552,57.8,1943,1943,1000,51.5,2523,2523,2174,86.2
8077,120743,120743,75574,62.6,75537,62.6,69681,57.7,5856,4.8,37,0.0,45169,37.4,75537,75537,(X),7.8,61788,61788,35312,57.2,35291,57.1,32614,52.8,9948,9948,6204,62.4,21420,21420,15725,73.4
8079,750,750,429,57.2,429,57.2,422,56.3,7,0.9,0,0.0,321,42.8,429,429,(X),1.6,387,387,208,53.7,208,53.7,208,53.7,19,19,19,100.0,59,59,51,86.4
8081,10109,10109,6531,64.6,6531,64.6,6266,62.0,265,2.6,0,0.0,3578,35.4,6531,6531,(X),4.1,5035,5035,2856,56.7,2856,56.7,2754,54.7,1065,1065,638,59.9,2306,2306,1662,72.1
8083,20679,20679,11780,57.0,11780,57.0,11183,54.1,597,2.9,0,0.0,8899,43.0,11780,11780,(X),5.1,10597,10597,5739,54.2,5739,54.2,5509,52.0,1849,1849,1201,65.0,3648,3648,2581,70.8
8085,33205,33205,18643,56.1,18643,56.1,17337,52.2,1306,3.9,0,0.0,14562,43.9,18643,18643,(X),7.0,17000,17000,8757,51.5,8757,51.5,8185,48.1,2749,2749,1959,71.3,5845,5845,4068,69.6
8087,21640,21640,13818,63.9,13802,63.8,13191,61.0,611,2.8,16,0.1,7822,36.1,13802,13802,(X),4.4,10830,10830,5940,54.8,5940,54.8,5630,52.0,2435,2435,1439,59.1,4552,4552,3195,70.2
8089,14617,14617,7637,52.2,7637,52.2,6993,47.8,644,4.4,0,0.0,6980,47.8,7637,7637,(X),8.4,7599,7599,3624,47.7,3624,47.7,3368,44.3,1323,1323,707,53.4,2619,2619,1975,75.4
8091,4110,4110,2466,60.0,2466,60.0,2346,57.1,120,2.9,0,0.0,1644,40.0,2466,2466,(X),4.9,2076,2076,1137,54.8,1137,54.8,1080,52.0,184,184,155,84.2,493,493,398,80.7
8093,14699,14699,9551,65.0,9551,65.0,9038,61.5,513,3.5,0,0.0,5148,35.0,9551,9551,(X),5.4,6928,6928,4513,65.1,4513,65.1,4342,62.7,900,900,702,78.0,1937,1937,1435,74.1
8095,3327,3327,2064,62.0,2064,62.0,2028,61.0,36,1.1,0,0.0,1263,38.0,2064,2064,(X),1.7,1517,1517,799,52.7,799,52.7,770,50.8,317,317,177,55.8,775,775,545,70.3
8097,15391,15391,12278,79.8,12273,79.7,11742,76.3,531,3.5,5,0.0,3113,20.2,12273,12273,(X),4.3,7380,7380,5557,75.3,5557,75.3,5381,72.9,811,811,638,78.7,1890,1890,1611,85.2
8099,9333,9333,5793,62.1,5793,62.1,5350,57.3,443,4.7,0,0.0,3540,37.9,5793,5793,(X),7.6,4704,4704,2629,55.9,2629,55.9,2467,52.4,890,890,586,65.8,2027,2027,1623,80.1
8101,131204,131204,74283,56.6,74061,56.4,67809,51.7,6252,4.8,222,0.2,56921,43.4,74061,74061,(X),8.4,67155,67155,36035,53.7,35998,53.6,33382,49.7,10913,10913,7047,64.6,23471,23471,16993,72.4
8103,4944,4944,3095,62.6,3095,62.6,2935,59.4,160,3.2,0,0.0,1849,37.4,3095,3095,(X),5.2,2420,2420,1386,57.3,1386,57.3,1281,52.9,547,547,325,59.4,1086,1086,774,71.3
8105,9111,9111,4949,54.3,4949,54.3,4481,49.2,468,5.1,0,0.0,4162,45.7,4949,4949,(X),9.5,4574,4574,2144,46.9,2144,46.9,2055,44.9,755,755,497,65.8,1657,1657,1053,63.5
8107,20919,20919,15136,72.4,15082,72.1,14631,69.9,451,2.2,54,0.3,5783,27.6,15082,15082,(X),3.0,9989,9989,6840,68.5,6840,68.5,6678,66.9,1390,1390,1125,80.9,3142,3142,2641,84.1
8109,5198,5198,2698,51.9,2695,51.8,2510,48.3,185,3.6,3,0.1,2500,48.1,2695,2695,(X),6.9,2575,2575,1184,46.0,1184,46.0,1128,43.8,413,413,188,45.5,942,942,612,65.0
8111,485,485,319,65.8,319,65.8,310,63.9,9,1.9,0,0.0,166,34.2,319,319,(X),2.8,220,220,107,48.6,107,48.6,107,48.6,15,15,15,100.0,54,54,31,57.4
8113,6650,6650,5210,78.3,5210,78.3,5075,76.3,135,2.0,0,0.0,1440,21.7,5210,5210,(X),2.6,3105,3105,2273,73.2,2273,73.2,2190,70.5,402,402,309,76.9,1011,1011,833,82.4
8115,1863,1863,1040,55.8,1040,55.8,970,52.1,70,3.8,0,0.0,823,44.2,1040,1040,(X),6.7,951,951,475,49.9,475,49.9,454,47.7,178,178,115,64.6,328,328,278,84.8
8117,26020,26020,20541,78.9,20541,78.9,19827,76.2,714,2.7,0,0.0,5479,21.1,20541,20541,(X),3.5,11710,11710,8572,73.2,8572,73.2,8194,70.0,1405,1405,1076,76.6,3178,3178,2326,73.2
8119,20223,20223,12525,61.9,12470,61.7,11679,57.8,791,3.9,55,0.3,7698,38.1,12470,12470,(X),6.3,9987,9987,5962,59.7,5928,59.4,5507,55.1,1048,1048,618,59.0,3054,3054,2145,70.2
8121,3877,3877,2361,60.9,2361,60.9,2297,59.2,64,1.7,0,0.0,1516,39.1,2361,2361,(X),2.7,1911,1911,1083,56.7,1083,56.7,1047,54.8,280,280,205,73.2,744,744,554,74.5
8123,224773,224773,153211,68.2,153007,68.1,146177,65.0,6830,3.0,204,0.1,71562,31.8,153007,153007,(X),4.5,112355,112355,68267,60.8,68250,60.7,64792,57.7,25190,25190,15667,62.2,49849,49849,34055,68.3
8125,7643,7643,5234,68.5,5212,68.2,5078,66.4,134,1.8,22,0.3,2409,31.5,5212,5212,(X),2.6,3808,3808,2238,58.8,2238,58.8,2143,56.3,969,969,675,69.7,1681,1681,1301,77.4
9001,754186,754186,511280,67.8,511058,67.8,475513,63.0,35545,4.7,222,0.0,242906,32.2,511058,511058,(X),7.0,391255,391255,241871,61.8,241820,61.8,224668,57.4,61559,61559,41283,67.1,148844,148844,104799,70.4
9003,728562,728562,479694,65.8,479254,65.8,447893,61.5,31361,4.3,440,0.1,248868,34.2,479254,479254,(X),6.5,378802,378802,234992,62.0,234905,62.0,221077,58.4,54998,54998,40845,74.3,128217,128217,101347,79.0
9005,153270,153270,102813,67.1,102769,67.1,97390,63.5,5379,3.5,44,0.0,50457,32.9,102769,102769,(X),5.2,78249,78249,49514,63.3,49514,63.3,47096,60.2,9057,9057,6603,72.9,24076,24076,19220,79.8
9007,137404,137404,93564,68.1,93406,68.0,89022,64.8,4384,3.2,158,0.1,43840,31.9,93406,93406,(X),4.7,71178,71178,45254,63.6,45235,63.6,42994,60.4,8146,8146,6351,78.0,20948,20948,17366,82.9
9009,705188,705188,460161,65.3,459855,65.2,427791,60.7,32064,4.5,306,0.0,245027,34.7,459855,459855,(X),7.0,369590,369590,229167,62.0,229076,62.0,213943,57.9,52175,52175,37440,71.8,117330,117330,90780,77.4
9011,221822,221822,148769,67.1,141776,63.9,133036,60.0,8740,3.9,6993,3.2,73053,32.9,141776,141776,(X),6.2,111315,111315,68845,61.8,68140,61.2,63688,57.2,15658,15658,10926,69.8,35615,35615,27899,78.3
9013,128117,128117,85017,66.4,84849,66.2,80396,62.8,4453,3.5,168,0.1,43100,33.6,84849,84849,(X),5.2,64155,64155,41081,64.0,41068,64.0,39068,60.9,7421,7421,5528,74.5,18792,18792,15020,79.9
9015,96042,96042,63545,66.2,63387,66.0,59404,61.9,3983,4.1,158,0.2,32497,33.8,63387,63387,(X),6.3,48931,48931,30994,63.3,30992,63.3,29166,59.6,6773,6773,5093,75.2,15548,15548,12623,81.2
10001,138560,138560,86649,62.5,84194,60.8,79233,57.2,4961,3.6,2455,1.8,51911,37.5,84194,84194,(X),5.9,72759,72759,42362,58.2,42074,57.8,39635,54.5,12654,12654,8806,69.6,25103,25103,18953,75.5
10003,448732,448732,293232,65.3,292654,65.2,274190,61.1,18464,4.1,578,0.1,155500,34.7,292654,292654,(X),6.3,233665,233665,145026,62.1,144957,62.0,136227,58.3,36759,36759,27393,74.5,77673,77673,62056,79.9
10005,182501,182501,102742,56.3,102599,56.2,97523,53.4,5076,2.8,143,0.1,79759,43.7,102599,102599,(X),4.9,94825,94825,49010,51.7,48977,51.6,46671,49.2,12790,12790,8350,65.3,26327,26327,18981,72.1
11001,573275,573275,401740,70.1,398567,69.5,369194,64.4,29373,5.1,3173,0.6,171535,29.9,398567,398567,(X),7.4,304853,304853,207466,68.1,206953,67.9,191230,62.7,49463,49463,37367,75.5,64801,64801,50332,77.7
12001,220874,220874,131954,59.7,131825,59.7,123777,56.0,8048,3.6,129,0.1,88920,40.3,131825,131825,(X),6.1,115154,115154,65683,57.0,65639,57.0,62054,53.9,16293,16293,10713,65.8,28753,28753,21511,74.8
12003,21823,21823,11406,52.3,11390,52.2,10762,49.3,628,2.9,16,0.1,10417,47.7,11390,11390,(X),5.5,10200,10200,5598,54.9,5598,54.9,5344,52.4,1815,1815,1476,81.3,4099,4099,3152,76.9
12005,147639,147639,89605,60.7,86317,58.5,81102,54.9,5215,3.5,3288,2.2,58034,39.3,86317,86317,(X),6.0,74494,74494,41694,56.0,41150,55.2,38856,52.2,13034,13034,8756,67.2,23704,23704,17293,73.0
12007,22163,22163,9931,44.8,9910,44.7,9324,42.1,586,2.6,21,0.1,12232,55.2,9910,9910,(X),5.9,9932,9932,4743,47.8,4743,47.8,4405,44.4,1664,1664,1004,60.3,3287,3287,2243,68.2
12009,483529,483529,262816,54.4,261578,54.1,245287,50.7,16291,3.4,1238,0.3,220713,45.6,261578,261578,(X),6.2,249100,249100,123855,49.7,123679,49.7,117135,47.0,31922,31922,20786,65.1,69394,69394,48501,69.9
12011,1548232,1548232,1017992,65.8,1016959,65.7,949870,61.4,67089,4.3,1033,0.1,530240,34.2,1016959,1016959,(X),6.6,801723,801723,488574,60.9,488470,60.9,455151,56.8,127403,127403,92128,72.3,262291,262291,199242,76.0
12013,11692,11692,5164,44.2,5156,44.1,4799,41.0,357,3.1,8,0.1,6528,55.8,5156,5156,(X),6.9,5060,5060,2329,46.0,2329,46.0,2104,41.6,712,712,532,74.7,1917,1917,1264,65.9
12015,157559,157559,65699,41.7,65669,41.7,60875,38.6,4794,3.0,30,0.0,91860,58.3,65669,65669,(X),7.3,81392,81392,32875,40.4,32875,40.4,30434,37.4,6045,6045,3836,63.5,14651,14651,10340,70.6
12017,124572,124572,50071,40.2,50063,40.2,45771,36.7,4292,3.4,8,0.0,74501,59.8,50063,50063,(X),8.6,64713,64713,24309,37.6,24309,37.6,22556,34.9,6039,6039,3740,61.9,13639,13639,8981,65.8
12019,164191,164191,102681,62.5,100946,61.5,93396,56.9,7550,4.6,1735,1.1,61510,37.5,100946,100946,(X),7.5,84254,84254,48056,57.0,47750,56.7,43400,51.5,13414,13414,8308,61.9,32852,32852,23078,70.2
12021,306944,306944,162071,52.8,161981,52.8,154513,50.3,7468,2.4,90,0.0,144873,47.2,161981,161981,(X),4.6,156748,156748,74037,47.2,74037,47.2,69978,44.6,18640,18640,11954,64.1,42607,42607,30909,72.5
12023,55717,55717,28690,51.5,28676,51.5,25965,46.6,2711,4.9,14,0.0,27027,48.5,28676,28676,(X),9.5,26992,26992,13689,50.7,13689,50.7,12610,46.7,4950,4950,3361,67.9,8659,8659,5987,69.1
12027,30080,30080,14011,46.6,14011,46.6,13309,44.2,702,2.3,0,0.0,16069,53.4,14011,14011,(X),5.0,12778,12778,4850,38.0,4850,38.0,4498,35.2,2150,2150,1129,52.5,4346,4346,2617,60.2
12029,13784,13784,5046,36.6,5046,36.6,4768,34.6,278,2.0,0,0.0,8738,63.4,5046,5046,(X),5.5,6036,6036,2267,37.6,2267,37.6,2140,35.5,686,686,397,57.9,1971,1971,1149,58.3
12031,736370,736370,483748,65.7,471849,64.1,440797,59.9,31052,4.2,11899,1.6,252622,34.3,471849,471849,(X),6.6,383865,383865,234546,61.1,232543,60.6,216866,56.5,70927,70927,47226,66.6,127161,127161,93232,73.3
12033,253420,253420,153098,60.4,144311,56.9,134938,53.2,9373,3.7,8787,3.5,100322,39.6,144311,144311,(X),6.5,128345,128345,71170,55.5,69690,54.3,65039,50.7,20938,20938,13431,64.1,39091,39091,26718,68.3
12035,90732,90732,43063,47.5,43037,47.4,40662,44.8,2375,2.6,26,0.0,47669,52.5,43037,43037,(X),5.5,47688,47688,21077,44.2,21077,44.2,20073,42.1,4598,4598,3136,68.2,12290,12290,8940,72.7
12037,9984,9984,4494,45.0,4494,45.0,4158,41.6,336,3.4,0,0.0,5490,55.0,4494,4494,(X),7.5,4205,4205,2040,48.5,2040,48.5,1948,46.3,513,513,381,74.3,1108,1108,752,67.9
12039,36778,36778,17797,48.4,17763,48.3,16386,44.6,1377,3.7,34,0.1,18981,51.6,17763,17763,(X),7.8,19467,19467,9014,46.3,9014,46.3,8321,42.7,3084,3084,1956,63.4,6132,6132,4425,72.2
12041,14590,14590,7215,49.5,7215,49.5,6775,46.4,440,3.0,0,0.0,7375,50.5,7215,7215,(X),6.1,6873,6873,3315,48.2,3315,48.2,3123,45.4,943,943,469,49.7,2153,2153,1347,62.6
12043,11359,11359,4217,37.1,4217,37.1,3763,33.1,454,4.0,0,0.0,7142,62.9,4217,4217,(X),10.8,4983,4983,1767,35.5,1767,35.5,1574,31.6,468,468,310,66.2,1549,1549,732,47.3
12045,13765,13765,6145,44.6,6106,44.4,5654,41.1,452,3.3,39,0.3,7620,55.4,6106,6106,(X),7.4,5429,5429,2484,45.8,2484,45.8,2261,41.6,918,918,491,53.5,1411,1411,905,64.1
12047,11861,11861,4284,36.1,4284,36.1,3658,30.8,626,5.3,0,0.0,7577,63.9,4284,4284,(X),14.6,4817,4817,2091,43.4,2091,43.4,1840,38.2,830,830,338,40.7,1737,1737,1189,68.5
12049,20696,20696,10648,51.4,10648,51.4,10011,48.4,637,3.1,0,0.0,10048,48.6,10648,10648,(X),6.0,9648,9648,4612,47.8,4612,47.8,4350,45.1,1850,1850,1087,58.8,4977,4977,3102,62.3
12051,30659,30659,18335,59.8,18335,59.8,16808,54.8,1527,5.0,0,0.0,12324,40.2,18335,18335,(X),8.3,14356,14356,7451,51.9,7451,51.9,6652,46.3,3370,3370,1800,53.4,6778,6778,4642,68.5
12053,152965,152965,71600,46.8,71502,46.7,66227,43.3,5275,3.4,98,0.1,81365,53.2,71502,71502,(X),7.4,80168,80168,34451,43.0,34451,43.0,31954,39.9,9388,9388,6308,67.2,21892,21892,14881,68.0
12055,86414,86414,36778,42.6,36778,42.6,32793,37.9,3985,4.6,0,0.0,49636,57.4,36778,36778,(X),10.8,44749,44749,17428,38.9,17428,38.9,15738,35.2,5217,5217,3606,69.1,11338,11338,7522,66.3
12057,1099131,1099131,713661,64.9,708895,64.5,665406,60.5,43489,4.0,4766,0.4,385470,35.1,708895,708895,(X),6.1,568957,568957,341781,60.1,340847,59.9,319254,56.1,99672,99672,66568,66.8,200260,200260,146129,73.0
12059,16046,16046,7404,46.1,7357,45.8,6567,40.9,790,4.9,47,0.3,8642,53.9,7357,7357,(X),10.7,7363,7363,3310,45.0,3310,45.0,2839,38.6,968,968,718,74.2,2310,2310,1607,69.6
12061,128348,128348,61412,47.8,61303,47.8,56931,44.4,4372,3.4,109,0.1,66936,52.2,61303,61303,(X),7.1,67723,67723,29396,43.4,29396,43.4,27207,40.2,7529,7529,5453,72.4,15818,15818,10197,64.5
12063,40615,40615,18009,44.3,18009,44.3,16418,40.4,1591,3.9,0,0.0,22606,55.7,18009,18009,(X),8.8,17848,17848,8985,50.3,8985,50.3,8344,46.8,2602,2602,1937,74.4,5645,5645,4066,72.0
12065,12053,12053,5525,45.8,5520,45.8,5247,43.5,273,2.3,5,0.0,6528,54.2,5520,5520,(X),4.9,5551,5551,2973,53.6,2973,53.6,2819,50.8,716,716,402,56.1,1398,1398,921,65.9
12067,7122,7122,2839,39.9,2839,39.9,2456,34.5,383,5.4,0,0.0,4283,60.1,2839,2839,(X),13.5,2741,2741,1137,41.5,1137,41.5,1017,37.1,777,777,365,47.0,975,975,668,68.5
12069,277084,277084,145387,52.5,145246,52.4,135768,49.0,9478,3.4,141,0.1,131697,47.5,145246,145246,(X),6.5,144475,144475,71260,49.3,71255,49.3,66282,45.9,19568,19568,12847,65.7,42686,42686,31012,72.7
12071,603414,603414,318206,52.7,317948,52.7,299106,49.6,18842,3.1,258,0.0,285208,47.3,317948,317948,(X),5.9,310746,310746,150999,48.6,150973,48.6,141324,45.5,39364,39364,26406,67.1,84682,84682,62422,73.7
12073,240470,240470,158017,65.7,157811,65.6,145442,60.5,12369,5.1,206,0.1,82453,34.3,157811,157811,(X),7.8,127718,127718,79830,62.5,79730,62.4,73861,57.8,17106,17106,11878,69.4,34233,34233,26570,77.6
12075,32804,32804,16043,48.9,16043,48.9,14954,45.6,1089,3.3,0,0.0,16761,51.1,16043,16043,(X),6.8,16998,16998,7832,46.1,7832,46.1,7296,42.9,2282,2282,1427,62.5,4968,4968,3491,70.3
12077,7167,7167,2735,38.2,2735,38.2,2425,33.8,310,4.3,0,0.0,4432,61.8,2735,2735,(X),11.3,2768,2768,1157,41.8,1157,41.8,1110,40.1,397,397,338,85.1,814,814,663,81.4
12079,15393,15393,6541,42.5,6541,42.5,6169,40.1,372,2.4,0,0.0,8852,57.5,6541,6541,(X),5.7,7153,7153,3194,44.7,3194,44.7,3052,42.7,1060,1060,670,63.2,2147,2147,1659,77.3
12081,311554,311554,166886,53.6,166754,53.5,156850,50.3,9904,3.2,132,0.0,144668,46.4,166754,166754,(X),5.9,162570,162570,79888,49.1,79881,49.1,75397,46.4,21354,21354,13974,65.4,44975,44975,31988,71.1
12083,290875,290875,134897,46.4,134735,46.3,122825,42.2,11910,4.1,162,0.1,155978,53.6,134735,134735,(X),8.8,153002,153002,66780,43.6,66749,43.6,61514,40.2,20033,20033,12624,63.0,40641,40641,27064,66.6
12085,134443,134443,69625,51.8,69251,51.5,65578,48.8,3673,2.7,374,0.3,64818,48.2,69251,69251,(X),5.3,68162,68162,32660,47.9,32535,47.7,30878,45.3,7171,7171,4415,61.6,17952,17952,12543,69.9
12086,2225127,2225127,1389936,62.5,1388666,62.4,1301540,58.5,87126,3.9,1270,0.1,835191,37.5,1388666,1388666,(X),6.3,1156157,1156157,655442,56.7,655223,56.7,612311,53.0,179790,179790,123545,68.7,349919,349919,255061,72.9
12087,66241,66241,42828,64.7,41588,62.8,40392,61.0,1196,1.8,1240,1.9,23413,35.3,41588,41588,(X),2.9,31503,31503,18930,60.1,18798,59.7,18333,58.2,4026,4026,2993,74.3,7003,7003,4995,71.3
12089,66527,66527,38683,58.1,38196,57.4,36402,54.7,1794,2.7,487,0.7,27844,41.9,38196,38196,(X),4.7,33924,33924,17477,51.5,17442,51.4,16638,49.0,4584,4584,2885,62.9,10765,10765,7107,66.0
12091,160704,160704,102023,63.5,92723,57.7,87493,54.4,5230,3.3,9300,5.8,58681,36.5,92723,92723,(X),5.6,79254,79254,44408,56.0,43331,54.7,40842,51.5,15306,15306,9223,60.3,26839,26839,18580,69.2
12093,32980,32980,15856,48.1,15846,48.0,14722,44.6,1124,3.4,10,0.0,17124,51.9,15846,15846,(X),7.1,15136,15136,6697,44.2,6697,44.2,6335,41.9,2480,2480,988,39.8,5213,5213,3034,58.2
12095,1056717,1056717,704521,66.7,704100,66.6,661930,62.6,42170,4.0,421,0.0,352196,33.3,704100,704100,(X),6.0,543314,543314,334191,61.5,334085,61.5,313507,57.7,93868,93868,63229,67.4,190519,190519,138946,72.9
12097,265154,265154,166047,62.6,165934,62.6,155492,58.6,10442,3.9,113,0.0,99107,37.4,165934,165934,(X),6.3,136143,136143,78063,57.3,78039,57.3,72866,53.5,25444,25444,15936,62.6,55058,55058,37384,67.9
12099,1199454,1199454,716878,59.8,716569,59.7,669887,55.8,46682,3.9,309,0.0,482576,40.2,716569,716569,(X),6.5,624568,624568,338399,54.2,338385,54.2,316092,50.6,85575,85575,59195,69.2,180748,180748,134234,74.3
12101,419278,419278,223789,53.4,223339,53.3,208871,49.8,14468,3.5,450,0.1,195489,46.6,223339,223339,(X),6.5,217752,217752,106823,49.1,106800,49.0,100477,46.1,30692,30692,19326,63.0,67593,67593,45835,67.8
12103,817802,817802,474093,58.0,472955,57.8,446120,54.6,26835,3.3,1138,0.1,343709,42.0,472955,472955,(X),5.7,429444,429444,233289,54.3,233079,54.3,221002,51.5,49850,49850,33536,67.3,100488,100488,74149,73.8
12105,535543,535543,294271,54.9,293895,54.9,273691,51.1,20204,3.8,376,0.1,241272,45.1,293895,293895,(X),6.9,276253,276253,137729,49.9,137724,49.9,127755,46.2,45745,45745,27759,60.7,95731,95731,63629,66.5
12107,58773,58773,27946,47.5,27904,47.5,24985,42.5,2919,5.0,42,0.1,30827,52.5,27904,27904,(X),10.5,29996,29996,13413,44.7,13413,44.7,11943,39.8,4746,4746,3018,63.6,9194,9194,6297,68.5
12109,190328,190328,114286,60.0,113569,59.7,108015,56.8,5554,2.9,717,0.4,76042,40.0,113569,113569,(X),4.9,98556,98556,53089,53.9,53028,53.8,50094,50.8,14150,14150,9344,66.0,35220,35220,22951,65.2
12111,251190,251190,135123,53.8,135019,53.8,126185,50.2,8834,3.5,104,0.0,116067,46.2,135019,135019,(X),6.5,130035,130035,64764,49.8,64764,49.8,60616,46.6,18496,18496,12484,67.5,40678,40678,29047,71.4
12113,137129,137129,80253,58.5,77352,56.4,72986,53.2,4366,3.2,2901,2.1,56876,41.5,77352,77352,(X),5.6,67239,67239,36808,54.7,36435,54.2,34349,51.1,11111,11111,6762,60.9,24625,24625,16354,66.4
12115,359861,359861,174640,48.5,174578,48.5,166424,46.2,8154,2.3,62,0.0,185221,51.5,174578,174578,(X),4.7,190056,190056,84674,44.6,84674,44.6,80866,42.5,17714,17714,11361,64.1,39827,39827,28565,71.7
12117,369943,369943,241072,65.2,240338,65.0,226769,61.3,13569,3.7,734,0.2,128871,34.8,240338,240338,(X),5.6,193151,193151,116115,60.1,116058,60.1,109926,56.9,28241,28241,18411,65.2,64715,64715,45956,71.0
12119,113104,113104,26706,23.6,26701,23.6,25437,22.5,1264,1.1,5,0.0,86398,76.4,26701,26701,(X),4.7,56517,56517,13793,24.4,13793,24.4,13270,23.5,2153,2153,1316,61.1,5694,5694,4381,76.9
12121,35583,35583,18140,51.0,18140,51.0,16817,47.3,1323,3.7,0,0.0,17443,49.0,18140,18140,(X),7.3,17300,17300,7653,44.2,7653,44.2,7143,41.3,2548,2548,1591,62.4,6333,6333,4175,65.9
12123,18353,18353,6918,37.7,6918,37.7,6486,35.3,432,2.4,0,0.0,11435,62.3,6918,6918,(X),6.2,7932,7932,3409,43.0,3409,43.0,3238,40.8,894,894,495,55.4,2375,2375,1550,65.3
12125,12682,12682,4080,32.2,4080,32.2,3724,29.4,356,2.8,0,0.0,8602,67.8,4080,4080,(X),8.7,4030,4030,2201,54.6,2201,54.6,2030,50.4,1020,1020,617,60.5,1700,1700,1038,61.1
12127,444927,444927,233179,52.4,233026,52.4,220015,49.4,13011,2.9,153,0.0,211748,47.6,233026,233026,(X),5.6,229480,229480,111976,48.8,111948,48.8,106024,46.2,28378,28378,17835,62.8,60600,60600,41406,68.3
12129,25829,25829,14174,54.9,14064,54.5,13328,51.6,736,2.8,110,0.4,11655,45.1,14064,14064,(X),5.2,11412,11412,6855,60.1,6855,60.1,6505,57.0,1755,1755,1150,65.5,4724,4724,3613,76.5
12131,53932,53932,31253,57.9,31015,57.5,29404,54.5,1611,3.0,238,0.4,22679,42.1,31015,31015,(X),5.2,26635,26635,14558,54.7,14475,54.3,13576,51.0,4103,4103,2351,57.3,8322,8322,5460,65.6
12133,20237,20237,9358,46.2,9342,46.2,8527,42.1,815,4.0,16,0.1,10879,53.8,9342,9342,(X),8.7,9125,9125,4468,49.0,4468,49.0,4084,44.8,1557,1557,818,52.5,3017,3017,1890,62.6
13001,14381,14381,7764,54.0,7756,53.9,7296,50.7,460,3.2,8,0.1,6617,46.0,7756,7756,(X),5.9,7236,7236,3534,48.8,3534,48.8,3271,45.2,1402,1402,804,57.3,2909,2909,1878,64.6
13003,6248,6248,3488,55.8,3488,55.8,3168,50.7,320,5.1,0,0.0,2760,44.2,3488,3488,(X),9.2,3137,3137,1631,52.0,1631,52.0,1413,45.0,646,646,307,47.5,1437,1437,816,56.8
13005,8628,8628,4376,50.7,4376,50.7,4146,48.1,230,2.7,0,0.0,4252,49.3,4376,4376,(X),5.3,4463,4463,2075,46.5,2075,46.5,1930,43.2,1100,1100,751,68.3,1661,1661,1228,73.9
13007,2633,2633,1303,49.5,1303,49.5,1251,47.5,52,2.0,0,0.0,1330,50.5,1303,1303,(X),4.0,1398,1398,600,42.9,600,42.9,591,42.3,175,175,85,48.6,380,380,248,65.3
13009,37591,37591,19637,52.2,19544,52.0,17708,47.1,1836,4.9,93,0.2,17954,47.8,19544,19544,(X),9.4,18650,18650,9795,52.5,9795,52.5,8811,47.2,2539,2539,2214,87.2,5452,5452,4272,78.4
13011,14796,14796,8235,55.7,8231,55.6,7795,52.7,436,2.9,4,0.0,6561,44.3,8231,8231,(X),5.3,7520,7520,3675,48.9,3675,48.9,3523,46.8,1202,1202,710,59.1,2853,2853,1924,67.4
13013,58691,58691,37566,64.0,37566,64.0,35632,60.7,1934,3.3,0,0.0,21125,36.0,37566,37566,(X),5.1,30218,30218,17202,56.9,17202,56.9,16388,54.2,6143,6143,3787,61.6,13082,13082,8977,68.6
13015,81090,81090,50951,62.8,50852,62.7,47997,59.2,2855,3.5,99,0.1,30139,37.2,50852,50852,(X),5.6,41454,41454,23747,57.3,23747,57.3,22365,54.0,7809,7809,5147,65.9,16524,16524,11682,70.7
13017,13359,13359,6634,49.7,6627,49.6,6313,47.3,314,2.4,7,0.1,6725,50.3,6627,6627,(X),4.7,7179,7179,3420,47.6,3420,47.6,3326,46.3,1118,1118,777,69.5,2698,2698,1792,66.4
13019,14957,14957,7841,52.4,7748,51.8,7085,47.4,663,4.4,93,0.6,7116,47.6,7748,7748,(X),8.6,7663,7663,3545,46.3,3536,46.1,3247,42.4,1295,1295,671,51.8,2888,2888,1671,57.9
13021,120201,120201,68386,56.9,68225,56.8,62200,51.7,6025,5.0,161,0.1,51815,43.1,68225,68225,(X),8.8,65277,65277,35956,55.1,35893,55.0,32979,50.5,12091,12091,9115,75.4,23288,23288,17563,75.4
13023,10338,10338,4566,44.2,4566,44.2,4230,40.9,336,3.3,0,0.0,5772,55.8,4566,4566,(X),7.4,5562,5562,2181,39.2,2181,39.2,1982,35.6,745,745,584,78.4,1735,1735,1190,68.6
13025,14554,14554,7177,49.3,7143,49.1,6729,46.2,414,2.8,34,0.2,7377,50.7,7143,7143,(X),5.8,7521,7521,3605,47.9,3605,47.9,3382,45.0,1272,1272,559,43.9,2582,2582,1577,61.1
13027,12647,12647,6468,51.1,6458,51.1,5800,45.9,658,5.2,10,0.1,6179,48.9,6458,6458,(X),10.2,6643,6643,2914,43.9,2914,43.9,2573,38.7,986,986,531,53.9,2263,2263,1487,65.7
13029,26693,26693,18111,67.8,16987,63.6,15755,59.0,1232,4.6,1124,4.2,8582,32.2,16987,16987,(X),7.3,13666,13666,8313,60.8,8260,60.4,7662,56.1,2840,2840,1706,60.1,7229,7229,4797,66.4
13031,61320,61320,36437,59.4,36373,59.3,33249,54.2,3124,5.1,64,0.1,24883,40.6,36373,36373,(X),8.6,31420,31420,17284,55.0,17284,55.0,15821,50.4,4705,4705,3029,64.4,9488,9488,6925,73.0
13033,17390,17390,9540,54.9,9505,54.7,9028,51.9,477,2.7,35,0.2,7850,45.1,9505,9505,(X),5.0,9305,9305,4597,49.4,4597,49.4,4391,47.2,1842,1842,1112,60.4,3363,3363,2262,67.3
13035,19323,19323,9445,48.9,9445,48.9,8915,46.1,530,2.7,0,0.0,9878,51.1,9445,9445,(X),5.6,8768,8768,4319,49.3,4319,49.3,4053,46.2,1294,1294,559,43.2,3332,3332,2173,65.2
13037,5433,5433,1908,35.1,1908,35.1,1622,29.9,286,5.3,0,0.0,3525,64.9,1908,1908,(X),15.0,2072,2072,1033,49.9,1033,49.9,806,38.9,236,236,183,77.5,698,698,529,75.8
13039,41008,41008,26716,65.1,23032,56.2,21340,52.0,1692,4.1,3684,9.0,14292,34.9,23032,23032,(X),7.3,19946,19946,11238,56.3,11163,56.0,10178,51.0,4541,4541,2598,57.2,7732,7732,5893,76.2
13043,8433,8433,4563,54.1,4560,54.1,4272,50.7,288,3.4,3,0.0,3870,45.9,4560,4560,(X),6.3,4325,4325,2112,48.8,2112,48.8,1960,45.3,873,873,562,64.4,1675,1675,1231,73.5
13045,91456,91456,55407,60.6,55303,60.5,50923,55.7,4380,4.8,104,0.1,36049,39.4,55303,55303,(X),7.9,47760,47760,26242,54.9,26242,54.9,24006,50.3,8501,8501,5475,64.4,17659,17659,11986,67.9
13047,52889,52889,33046,62.5,33020,62.4,31719,60.0,1301,2.5,26,0.0,19843,37.5,33020,33020,(X),3.9,27845,27845,15550,55.8,15549,55.8,14922,53.6,4351,4351,2784,64.0,10014,10014,7279,72.7
13049,10655,10655,4781,44.9,4781,44.9,4199,39.4,582,5.5,0,0.0,5874,55.1,4781,4781,(X),12.2,4198,4198,1901,45.3,1901,45.3,1640,39.1,796,796,489,61.4,1410,1410,721,51.1
13051,231090,231090,150275,65.0,147441,63.8,135574,58.7,11867,5.1,2834,1.2,80815,35.0,147441,147441,(X),8.0,121576,121576,74359,61.2,73936,60.8,67465,55.5,20734,20734,14717,71.0,38163,38163,29406,77.1
13053,8538,8538,6849,80.2,2408,28.2,2177,25.5,231,2.7,4441,52.0,1689,19.8,2408,2408,(X),9.6,2467,2467,1333,54.0,1108,44.9,953,38.6,1011,1011,397,39.3,1235,1235,499,40.4
13055,19894,19894,9745,49.0,9744,49.0,8946,45.0,798,4.0,1,0.0,10149,51.0,9744,9744,(X),8.2,9594,9594,4675,48.7,4675,48.7,4309,44.9,1492,1492,900,60.3,3280,3280,2294,69.9
13057,188094,188094,128143,68.1,128026,68.1,122561,65.2,5465,2.9,117,0.1,59951,31.9,128026,128026,(X),4.3,96520,96520,59150,61.3,59150,61.3,56114,58.1,17405,17405,11051,63.5,41813,41813,29842,71.4
13059,105156,105156,62979,59.9,62797,59.7,58766,55.9,4031,3.8,182,0.2,42177,40.1,62797,62797,(X),6.4,55801,55801,30666,55.0,30649,54.9,28897,51.8,7608,7608,4915,64.6,13063,13063,9231,70.7
13061,2462,2462,1059,43.0,1059,43.0,876,35.6,183,7.4,0,0.0,1403,57.0,1059,1059,(X),17.3,1184,1184,392,33.1,392,33.1,357,30.2,173,173,74,42.8,353,353,201,56.9
13063,208902,208902,138635,66.4,138459,66.3,126643,60.6,11816,5.7,176,0.1,70267,33.6,138459,138459,(X),8.5,113484,113484,73343,64.6,73269,64.6,66689,58.8,24606,24606,17846,72.5,49124,49124,36349,74.0
13065,5118,5118,2417,47.2,2417,47.2,2257,44.1,160,3.1,0,0.0,2701,52.8,2417,2417,(X),6.6,2640,2640,1363,51.6,1363,51.6,1252,47.4,600,600,486,81.0,961,961,770,80.1
13067,585321,585321,411153,70.2,410340,70.1,389803,66.6,20537,3.5,813,0.1,174168,29.8,410340,410340,(X),5.0,306016,306016,197058,64.4,196814,64.3,186617,61.0,55996,55996,36588,65.3,117738,117738,84992,72.2
13069,33577,33577,17432,51.9,17428,51.9,16627,49.5,801,2.4,4,0.0,16145,48.1,17428,17428,(X),4.6,16388,16388,8811,53.8,8811,53.8,8451,51.6,3584,3584,2697,75.3,6428,6428,4598,71.5
13071,34737,34737,20126,57.9,20108,57.9,18736,53.9,1372,3.9,18,0.1,14611,42.1,20108,20108,(X),6.8,17696,17696,9170,51.8,9170,51.8,8405,47.5,3489,3489,2478,71.0,7449,7449,5411,72.6
13073,114038,114038,72696,63.7,68979,60.5,65411,57.4,3568,3.1,3717,3.3,41342,36.3,68979,68979,(X),5.2,58915,58915,33826,57.4,33234,56.4,31325,53.2,11366,11366,6491,57.1,25122,25122,17593,70.0
13075,13282,13282,7467,56.2,7467,56.2,7078,53.3,389,2.9,0,0.0,5815,43.8,7467,7467,(X),5.2,7070,7070,3570,50.5,3570,50.5,3402,48.1,1266,1266,724,57.2,2881,2881,1982,68.8
13077,109381,109381,72137,66.0,72087,65.9,68690,62.8,3397,3.1,50,0.0,37244,34.0,72087,72087,(X),4.7,56815,56815,33847,59.6,33826,59.5,32037,56.4,9984,9984,6665,66.8,23292,23292,16418,70.5
13079,10083,10083,5168,51.3,5140,51.0,4644,46.1,496,4.9,28,0.3,4915,48.7,5140,5140,(X),9.6,4947,4947,2534,51.2,2521,51.0,2304,46.6,708,708,378,53.4,1636,1636,1027,62.8
13081,17783,17783,10024,56.4,10024,56.4,8798,49.5,1226,6.9,0,0.0,7759,43.6,10024,10024,(X),12.2,9544,9544,4785,50.1,4785,50.1,4175,43.7,1604,1604,1406,87.7,3606,3606,2778,77.0
13083,13540,13540,7739,57.2,7644,56.5,7331,54.1,313,2.3,95,0.7,5801,42.8,7644,7644,(X),4.1,6975,6975,3823,54.8,3823,54.8,3638,52.2,776,776,427,55.0,1879,1879,1134,60.4
13085,19482,19482,11791,60.5,11698,60.0,11230,57.6,468,2.4,93,0.5,7691,39.5,11698,11698,(X),4.0,9914,9914,5373,54.2,5296,53.4,5151,52.0,1508,1508,825,54.7,2994,2994,2174,72.6
13087,20981,20981,10286,49.0,10200,48.6,9645,46.0,555,2.6,86,0.4,10695,51.0,10200,10200,(X),5.4,11011,11011,4886,44.4,4873,44.3,4515,41.0,2018,2018,1042,51.6,4334,4334,2839,65.5
13089,586377,586377,405541,69.2,405043,69.1,375217,64.0,29826,5.1,498,0.1,180836,30.8,405043,405043,(X),7.4,313752,313752,206727,65.9,206655,65.9,191310,61.0,60416,60416,43129,71.4,103749,103749,79417,76.5
13091,17162,17162,8059,47.0,8050,46.9,7467,43.5,583,3.4,9,0.1,9103,53.0,8050,8050,(X),7.2,8195,8195,3892,47.5,3892,47.5,3568,43.5,1197,1197,711,59.4,2739,2739,1789,65.3
13093,11726,11726,5757,49.1,5757,49.1,5038,43.0,719,6.1,0,0.0,5969,50.9,5757,5757,(X),12.5,5278,5278,2470,46.8,2470,46.8,2125,40.3,647,647,388,60.0,1615,1615,1065,65.9
13095,71320,71320,41238,57.8,40984,57.5,35167,49.3,5817,8.2,254,0.4,30082,42.2,40984,40984,(X),14.2,39391,39391,22000,55.9,22000,55.9,18906,48.0,6661,6661,4982,74.8,13415,13415,9375,69.9
13097,109399,109399,72917,66.7,72898,66.6,67891,62.1,5007,4.6,19,0.0,36482,33.3,72898,72898,(X),6.9,58399,58399,36295,62.2,36295,62.2,33653,57.6,10530,10530,7643,72.6,25357,25357,19346,76.3
13099,8155,8155,4069,49.9,4069,49.9,3761,46.1,308,3.8,0,0.0,4086,50.1,4069,4069,(X),7.6,4439,4439,2045,46.1,2045,46.1,1869,42.1,758,758,534,70.4,1638,1638,1199,73.2
13101,3251,3251,1765,54.3,1765,54.3,1675,51.5,90,2.8,0,0.0,1486,45.7,1765,1765,(X),5.1,1554,1554,660,42.5,660,42.5,618,39.8,209,209,105,50.2,570,570,355,62.3
13103,44642,44642,29610,66.3,29265,65.6,28083,62.9,1182,2.6,345,0.8,15032,33.7,29265,29265,(X),4.0,22859,22859,13136,57.5,13064,57.2,12351,54.0,4693,4693,2459,52.4,10244,10244,7212,70.4
13105,15440,15440,8197,53.1,8182,53.0,7626,49.4,556,3.6,15,0.1,7243,46.9,8182,8182,(X),6.8,8072,8072,3989,49.4,3982,49.3,3645,45.2,1228,1228,815,66.4,2541,2541,1900,74.8
13107,17372,17372,9031,52.0,9031,52.0,8340,48.0,691,4.0,0,0.0,8341,48.0,9031,9031,(X),7.7,8850,8850,4517,51.0,4517,51.0,4210,47.6,1729,1729,1086,62.8,3707,3707,2565,69.2
13109,8148,8148,4671,57.3,4662,57.2,4297,52.7,365,4.5,9,0.1,3477,42.7,4662,4662,(X),7.8,4282,4282,2240,52.3,2240,52.3,2076,48.5,972,972,581,59.8,1558,1558,1030,66.1
13111,21172,21172,10221,48.3,10221,48.3,9586,45.3,635,3.0,0,0.0,10951,51.7,10221,10221,(X),6.2,11102,11102,4990,44.9,4990,44.9,4785,43.1,1094,1094,794,72.6,2752,2752,2087,75.8
13113,89345,89345,55606,62.2,55469,62.1,52689,59.0,2780,3.1,137,0.2,33739,37.8,55469,55469,(X),5.0,46562,46562,26359,56.6,26268,56.4,24821,53.3,6000,6000,3886,64.8,19155,19155,13144,68.6
13115,76630,76630,44045,57.5,44012,57.4,41259,53.8,2753,3.6,33,0.0,32585,42.5,44012,44012,(X),6.3,40196,40196,21426,53.3,21416,53.3,20125,50.1,6406,6406,4432,69.2,14466,14466,10224,70.7
13117,165073,165073,113616,68.8,113512,68.8,109504,66.3,4008,2.4,104,0.1,51457,31.2,113512,113512,(X),3.5,84056,84056,50734,60.4,50734,60.4,48591,57.8,16883,16883,10529,62.4,44044,44044,29505,67.0
13119,18307,18307,9119,49.8,9117,49.8,8644,47.2,473,2.6,2,0.0,9188,50.2,9117,9117,(X),5.2,9556,9556,4173,43.7,4173,43.7,3883,40.6,1567,1567,691,44.1,3129,3129,1866,59.6
13121,816772,816772,553201,67.7,552497,67.6,516732,63.3,35765,4.4,704,0.1,263571,32.3,552497,552497,(X),6.5,425849,425849,270084,63.4,270001,63.4,251159,59.0,72425,72425,50098,69.2,148026,148026,107005,72.3
13123,24832,24832,13558,54.6,13530,54.5,12787,51.5,743,3.0,28,0.1,11274,45.4,13530,13530,(X),5.5,12315,12315,6208,50.4,6208,50.4,5833,47.4,1782,1782,931,52.2,3837,3837,2890,75.3
13125,2407,2407,1411,58.6,1411,58.6,1364,56.7,47,2.0,0,0.0,996,41.4,1411,1411,(X),3.3,1306,1306,691,52.9,691,52.9,671,51.4,157,157,98,62.4,519,519,455,87.7
13127,67031,67031,40825,60.9,40794,60.9,38572,57.5,2222,3.3,31,0.0,26206,39.1,40794,40794,(X),5.4,36131,36131,20718,57.3,20718,57.3,19417,53.7,5254,5254,3777,71.9,11827,11827,9069,76.7
13129,44541,44541,26911,60.4,26898,60.4,25667,57.6,1231,2.8,13,0.0,17630,39.6,26898,26898,(X),4.6,22887,22887,12024,52.5,12024,52.5,11432,49.9,4366,4366,3004,68.8,8901,8901,6602,74.2
13131,19358,19358,11051,57.1,11030,57.0,10303,53.2,727,3.8,21,0.1,8307,42.9,11030,11030,(X),6.6,10085,10085,5261,52.2,5261,52.2,4906,48.6,1758,1758,1479,84.1,4007,4007,3092,77.2
13133,14018,14018,6658,47.5,6633,47.3,6305,45.0,328,2.3,25,0.2,7360,52.5,6633,6633,(X),4.9,7329,7329,3257,44.4,3239,44.2,3055,41.7,762,762,503,66.0,2321,2321,1674,72.1
13135,684606,684606,473566,69.2,473052,69.1,450670,65.8,22382,3.3,514,0.1,211040,30.8,473052,473052,(X),4.7,353950,353950,222961,63.0,222928,63.0,211750,59.8,71642,71642,43142,60.2,167091,167091,118756,71.1
13137,35482,35482,18855,53.1,18831,53.1,18083,51.0,748,2.1,24,0.1,16627,46.9,18831,18831,(X),4.0,19065,19065,8512,44.6,8512,44.6,8277,43.4,3030,3030,2007,66.2,6560,6560,4449,67.8
13139,151110,151110,95561,63.2,95484,63.2,91959,60.9,3525,2.3,77,0.1,55549,36.8,95484,95484,(X),3.7,76696,76696,42459,55.4,42429,55.3,40724,53.1,14801,14801,9351,63.2,34027,34027,21836,64.2
13141,7390,7390,2060,27.9,2060,27.9,1977,26.8,83,1.1,0,0.0,5330,72.1,2060,2060,(X),4.0,2889,2889,1250,43.3,1250,43.3,1191,41.2,292,292,262,89.7,848,848,585,69.0
13143,22798,22798,12930,56.7,12911,56.6,12285,53.9,626,2.7,19,0.1,9868,43.3,12911,12911,(X),4.8,11896,11896,5854,49.2,5854,49.2,5522,46.4,1987,1987,1125,56.6,4519,4519,3476,76.9
13145,27173,27173,16632,61.2,16355,60.2,15186,55.9,1169,4.3,277,1.0,10541,38.8,16355,16355,(X),7.1,13800,13800,7425,53.8,7425,53.8,6913,50.1,1824,1824,1025,56.2,5129,5129,3491,68.1
13147,20850,20850,10457,50.2,10457,50.2,9948,47.7,509,2.4,0,0.0,10393,49.8,10457,10457,(X),4.9,10719,10719,4715,44.0,4715,44.0,4510,42.1,1666,1666,1142,68.5,3082,3082,1869,60.6
13149,9214,9214,5317,57.7,5317,57.7,4905,53.2,412,4.5,0,0.0,3897,42.3,5317,5317,(X),7.7,4741,4741,2511,53.0,2511,53.0,2264,47.8,778,778,461,59.3,1629,1629,1293,79.4
13151,171073,171073,112455,65.7,112198,65.6,104676,61.2,7522,4.4,257,0.2,58618,34.3,112198,112198,(X),6.7,90729,90729,56529,62.3,56453,62.2,52587,58.0,14719,14719,10647,72.3,41291,41291,31089,75.3
13153,116745,116745,76105,65.2,73723,63.1,68567,58.7,5156,4.4,2382,2.0,40640,34.8,73723,73723,(X),7.0,60829,60829,36650,60.3,36305,59.7,33611,55.3,11680,11680,7895,67.6,24643,24643,17538,71.2
13155,7517,7517,3608,48.0,3608,48.0,3277,43.6,331,4.4,0,0.0,3909,52.0,3608,3608,(X),9.2,3653,3653,1599,43.8,1599,43.8,1463,40.0,532,532,333,62.6,1282,1282,877,68.4
13157,50575,50575,31184,61.7,31056,61.4,29560,58.4,1496,3.0,128,0.3,19391,38.3,31056,31056,(X),4.8,25934,25934,14310,55.2,14294,55.1,13618,52.5,4912,4912,3235,65.9,11175,11175,8261,73.9
13159,10814,10814,5724,52.9,5724,52.9,5349,49.5,375,3.5,0,0.0,5090,47.1,5724,5724,(X),6.6,5669,5669,2724,48.1,2724,48.1,2494,44.0,790,790,377,47.7,2055,2055,1341,65.3
13161,11317,11317,5879,51.9,5879,51.9,5530,48.9,349,3.1,0,0.0,5438,48.1,5879,5879,(X),5.9,5873,5873,2456,41.8,2456,41.8,2306,39.3,1025,1025,533,52.0,2543,2543,1584,62.3
13163,12445,12445,6374,51.2,6374,51.2,5933,47.7,441,3.5,0,0.0,6071,48.8,6374,6374,(X),6.9,6575,6575,3123,47.5,3123,47.5,2932,44.6,1186,1186,631,53.2,2413,2413,1468,60.8
13165,6987,6987,3447,49.3,3447,49.3,3309,47.4,138,2.0,0,0.0,3540,50.7,3447,3447,(X),4.0,3966,3966,1753,44.2,1753,44.2,1657,41.8,879,879,572,65.1,1097,1097,771,70.3
13167,8028,8028,4628,57.6,4628,57.6,4211,52.5,417,5.2,0,0.0,3400,42.4,4628,4628,(X),9.0,3535,3535,1716,48.5,1716,48.5,1572,44.5,591,591,275,46.5,1123,1123,755,67.2
13169,22650,22650,13131,58.0,13080,57.7,12114,53.5,966,4.3,51,0.2,9519,42.0,13080,13080,(X),7.4,11777,11777,6337,53.8,6310,53.6,5784,49.1,1861,1861,1212,65.1,4516,4516,3224,71.4
13171,15239,15239,8041,52.8,8026,52.7,7132,46.8,894,5.9,15,0.1,7198,47.2,8026,8026,(X),11.1,7991,7991,3710,46.4,3710,46.4,3392,42.4,1087,1087,877,80.7,2310,2310,1732,75.0
13173,7945,7945,4246,53.4,3990,50.2,3643,45.9,347,4.4,256,3.2,3699,46.6,3990,3990,(X),8.7,3984,3984,2053,51.5,2020,50.7,1884,47.3,760,760,429,56.4,1677,1677,1300,77.5
13175,36928,36928,18218,49.3,18201,49.3,17326,46.9,875,2.4,17,0.0,18710,50.7,18201,18201,(X),4.8,19811,19811,9214,46.5,9214,46.5,8664,43.7,3757,3757,2283,60.8,7085,7085,4646,65.6
13177,22507,22507,14415,64.0,14330,63.7,13267,58.9,1063,4.7,85,0.4,8092,36.0,14330,14330,(X),7.4,11296,11296,7002,62.0,7002,62.0,6579,58.2,2243,2243,1634,72.8,4948,4948,3496,70.7
13179,46086,46086,31182,67.7,25617,55.6,22691,49.2,2926,6.3,5565,12.1,14904,32.3,25617,25617,(X),11.4,22714,22714,13353,58.8,12779,56.3,11272,49.6,6859,6859,3464,50.5,9811,9811,6751,68.8
13181,6462,6462,3427,53.0,3415,52.8,3259,50.4,156,2.4,12,0.2,3035,47.0,3415,3415,(X),4.6,3375,3375,1672,49.5,1672,49.5,1587,47.0,401,401,247,61.6,922,922,717,77.8
13183,13501,13501,8027,59.5,7338,54.4,6232,46.2,1106,8.2,689,5.1,5474,40.5,7338,7338,(X),15.1,6866,6866,3304,48.1,3161,46.0,2618,38.1,1680,1680,926,55.1,3192,3192,2073,64.9
13185,89905,89905,53261,59.2,50542,56.2,46705,51.9,3837,4.3,2719,3.0,36644,40.8,50542,50542,(X),7.6,46573,46573,25471,54.7,24959,53.6,22874,49.1,8978,8978,5220,58.1,16814,16814,10800,64.2
13187,26842,26842,16475,61.4,16397,61.1,15665,58.4,732,2.7,78,0.3,10367,38.6,16397,16397,(X),4.5,13839,13839,7805,56.4,7805,56.4,7518,54.3,1660,1660,1172,70.6,3813,3813,2603,68.3
13189,16576,16576,9379,56.6,9282,56.0,8513,51.4,769,4.6,97,0.6,7197,43.4,9282,9282,(X),8.3,9043,9043,4626,51.2,4601,50.9,4095,45.3,1668,1668,1197,71.8,3630,3630,2991,82.4
13191,11963,11963,6473,54.1,6405,53.5,5900,49.3,505,4.2,68,0.6,5490,45.9,6405,6405,(X),7.9,6157,6157,3121,50.7,3121,50.7,2914,47.3,567,567,395,69.7,1671,1671,1327,79.4
13193,11155,11155,5021,45.0,5016,45.0,4416,39.6,600,5.4,5,0.0,6134,55.0,5016,5016,(X),12.0,4953,4953,2352,47.5,2352,47.5,2086,42.1,894,894,598,66.9,1463,1463,975,66.6
13195,22852,22852,13698,59.9,13686,59.9,12522,54.8,1164,5.1,12,0.1,9154,40.1,13686,13686,(X),8.5,11660,11660,6664,57.2,6664,57.2,6102,52.3,1690,1690,1119,66.2,4199,4199,2798,66.6
13197,7075,7075,3833,54.2,3826,54.1,3432,48.5,394,5.6,7,0.1,3242,45.8,3826,3826,(X),10.3,3543,3543,1717,48.5,1717,48.5,1553,43.8,523,523,440,84.1,934,934,672,71.9
13199,17052,17052,8649,50.7,8646,50.7,8133,47.7,513,3.0,3,0.0,8403,49.3,8646,8646,(X),5.9,8949,8949,3827,42.8,3824,42.7,3702,41.4,1309,1309,897,68.5,2969,2969,2251,75.8
13201,4667,4667,2496,53.5,2496,53.5,2371,50.8,125,2.7,0,0.0,2171,46.5,2496,2496,(X),5.0,2461,2461,1270,51.6,1270,51.6,1208,49.1,413,413,241,58.4,858,858,661,77.0
13205,17722,17722,9524,53.7,9524,53.7,8216,46.4,1308,7.4,0,0.0,8198,46.3,9524,9524,(X),13.7,8462,8462,4689,55.4,4689,55.4,4026,47.6,1393,1393,1055,75.7,3366,3366,2666,79.2
13207,22125,22125,12531,56.6,12531,56.6,11536,52.1,995,4.5,0,0.0,9594,43.4,12531,12531,(X),7.9,11082,11082,6015,54.3,6015,54.3,5457,49.2,1559,1559,1143,73.3,3772,3772,3080,81.7
13209,7359,7359,3793,51.5,3793,51.5,3519,47.8,274,3.7,0,0.0,3566,48.5,3793,3793,(X),7.2,3568,3568,1729,48.5,1729,48.5,1584,44.4,492,492,297,60.4,1130,1130,884,78.2
13211,14560,14560,8644,59.4,8632,59.3,8139,55.9,493,3.4,12,0.1,5916,40.6,8632,8632,(X),5.7,7630,7630,4000,52.4,4000,52.4,3818,50.0,1148,1148,593,51.7,2354,2354,1767,75.1
13213,30742,30742,18374,59.8,18372,59.8,16935,55.1,1437,4.7,2,0.0,12368,40.2,18372,18372,(X),7.8,15682,15682,8095,51.6,8095,51.6,7331,46.7,2808,2808,1673,59.6,6224,6224,3960,63.6
13215,153031,153031,94368,61.7,87749,57.3,79636,52.0,8113,5.3,6619,4.3,58663,38.3,87749,87749,(X),9.2,78889,78889,44300,56.2,44080,55.9,39804,50.5,16486,16486,10666,64.7,29675,29675,20513,69.1
13217,81432,81432,51012,62.6,50867,62.5,46939,57.6,3928,4.8,145,0.2,30420,37.4,50867,50867,(X),7.7,43426,43426,25366,58.4,25366,58.4,23413,53.9,8240,8240,5428,65.9,18942,18942,13350,70.5
13219,28587,28587,18767,65.6,18767,65.6,18115,63.4,652,2.3,0,0.0,9820,34.4,18767,18767,(X),3.5,14774,14774,8721,59.0,8721,59.0,8353,56.5,2415,2415,1712,70.9,7157,7157,5531,77.3
13221,12000,12000,7037,58.6,7015,58.5,6684,55.7,331,2.8,22,0.2,4963,41.4,7015,7015,(X),4.7,6126,6126,3294,53.8,3287,53.7,3201,52.3,942,942,578,61.4,1986,1986,1272,64.0
13223,119266,119266,80332,67.4,80247,67.3,76827,64.4,3420,2.9,85,0.1,38934,32.6,80247,80247,(X),4.3,61949,61949,38413,62.0,38413,62.0,36814,59.4,11725,11725,7448,63.5,28491,28491,20277,71.2
13225,21830,21830,11696,53.6,11585,53.1,10524,48.2,1061,4.9,111,0.5,10134,46.4,11585,11585,(X),9.2,11405,11405,5516,48.4,5501,48.2,4997,43.8,1805,1805,1455,80.6,3771,3771,2717,72.0
13227,25169,25169,14607,58.0,14505,57.6,13613,54.1,892,3.5,102,0.4,10562,42.0,14505,14505,(X),6.1,12945,12945,6610,51.1,6610,51.1,6267,48.4,1748,1748,1170,66.9,4181,4181,2989,71.5
13229,14918,14918,8187,54.9,8161,54.7,7687,51.5,474,3.2,26,0.2,6731,45.1,8161,8161,(X),5.8,7596,7596,3629,47.8,3629,47.8,3344,44.0,1419,1419,1041,73.4,3031,3031,2316,76.4
13231,14417,14417,8303,57.6,8303,57.6,7774,53.9,529,3.7,0,0.0,6114,42.4,8303,8303,(X),6.4,7375,7375,3792,51.4,3792,51.4,3543,48.0,893,893,413,46.2,2960,2960,2167,73.2
13233,32249,32249,19200,59.5,19189,59.5,18048,56.0,1141,3.5,11,0.0,13049,40.5,19189,19189,(X),5.9,16432,16432,8449,51.4,8449,51.4,7793,47.4,3037,3037,1984,65.3,6784,6784,4561,67.2
13235,9741,9741,3895,40.0,3891,39.9,3704,38.0,187,1.9,4,0.0,5846,60.0,3891,3891,(X),4.8,5490,5490,1760,32.1,1760,32.1,1699,30.9,417,417,334,80.1,1366,1366,1005,73.6
13237,17658,17658,9711,55.0,9677,54.8,9234,52.3,443,2.5,34,0.2,7947,45.0,9677,9677,(X),4.6,9087,9087,4750,52.3,4750,52.3,4524,49.8,1228,1228,1024,83.4,2851,2851,2202,77.2
13239,1892,1892,899,47.5,899,47.5,799,42.2,100,5.3,0,0.0,993,52.5,899,899,(X),11.1,961,961,428,44.5,428,44.5,388,40.4,130,130,59,45.4,221,221,158,71.5
13241,14051,14051,6418,45.7,6412,45.6,6142,43.7,270,1.9,6,0.0,7633,54.3,6412,6412,(X),4.2,7140,7140,3040,42.6,3040,42.6,2913,40.8,831,831,416,50.1,1645,1645,1065,64.7
13243,5321,5321,2611,49.1,2611,49.1,2408,45.3,203,3.8,0,0.0,2710,50.9,2611,2611,(X),7.8,2766,2766,1285,46.5,1285,46.5,1164,42.1,550,550,223,40.5,1088,1088,880,80.9
13245,159492,159492,95644,60.0,90180,56.5,80890,50.7,9290,5.8,5464,3.4,63848,40.0,90180,90180,(X),10.3,83510,83510,47647,57.1,46884,56.1,42633,51.1,15576,15576,9784,62.8,28062,28062,19844,70.7
13247,69309,69309,42579,61.4,42506,61.3,39286,56.7,3220,4.6,73,0.1,26730,38.6,42506,42506,(X),7.6,37369,37369,21264,56.9,21239,56.8,19584,52.4,6065,6065,3667,60.5,14774,14774,11168,75.6
13249,4179,4179,2488,59.5,2488,59.5,2173,52.0,315,7.5,0,0.0,1691,40.5,2488,2488,(X),12.7,2079,2079,1150,55.3,1150,55.3,939,45.2,328,328,227,69.2,859,859,765,89.1
13251,11284,11284,5936,52.6,5908,52.4,5539,49.1,369,3.3,28,0.2,5348,47.4,5908,5908,(X),6.2,5871,5871,2801,47.7,2801,47.7,2574,43.8,985,985,793,80.5,1745,1745,1281,73.4
13253,6844,6844,3102,45.3,3102,45.3,2864,41.8,238,3.5,0,0.0,3742,54.7,3102,3102,(X),7.7,3706,3706,1442,38.9,1442,38.9,1298,35.0,493,493,239,48.5,1203,1203,706,58.7
13255,50639,50639,26938,53.2,26908,53.1,25042,49.5,1866,3.7,30,0.1,23701,46.8,26908,26908,(X),6.9,26541,26541,13026,49.1,12996,49.0,12099,45.6,4545,4545,2715,59.7,9938,9938,6820,68.6
13257,20590,20590,11335,55.1,11335,55.1,10301,50.0,1034,5.0,0,0.0,9255,44.9,11335,11335,(X),9.1,11121,11121,5576,50.1,5576,50.1,4982,44.8,1717,1717,1413,82.3,3504,3504,2401,68.5
13259,5360,5360,1660,31.0,1644,30.7,1498,27.9,146,2.7,16,0.3,3700,69.0,1644,1644,(X),8.9,1816,1816,880,48.5,880,48.5,842,46.4,214,214,177,82.7,485,485,330,68.0
13261,24015,24015,13058,54.4,13042,54.3,11841,49.3,1201,5.0,16,0.1,10957,45.6,13042,13042,(X),9.2,12919,12919,6399,49.5,6399,49.5,5664,43.8,2211,2211,1588,71.8,4219,4219,3114,73.8
13263,5437,5437,2754,50.7,2754,50.7,2536,46.6,218,4.0,0,0.0,2683,49.3,2754,2754,(X),7.9,2886,2886,1429,49.5,1429,49.5,1259,43.6,304,304,200,65.8,666,666,481,72.2
13265,1463,1463,640,43.7,640,43.7,580,39.6,60,4.1,0,0.0,823,56.3,640,640,(X),9.4,700,700,256,36.6,256,36.6,243,34.7,51,51,28,54.9,181,181,106,58.6
13267,20775,20775,8165,39.3,8111,39.0,7801,37.5,310,1.5,54,0.3,12610,60.7,8111,8111,(X),3.8,8232,8232,4107,49.9,4096,49.8,3920,47.6,1500,1500,930,62.0,3394,3394,2369,69.8
13269,6705,6705,3383,50.5,3383,50.5,2987,44.5,396,5.9,0,0.0,3322,49.5,3383,3383,(X),11.7,3565,3565,1792,50.3,1792,50.3,1554,43.6,436,436,236,54.1,1081,1081,751,69.5
13271,13604,13604,5050,37.1,5050,37.1,4919,36.2,131,1.0,0,0.0,8554,62.9,5050,5050,(X),2.6,5406,5406,2149,39.8,2149,39.8,2100,38.8,743,743,403,54.2,1882,1882,1117,59.4
13273,7100,7100,3676,51.8,3645,51.3,3332,46.9,313,4.4,31,0.4,3424,48.2,3645,3645,(X),8.6,3793,3793,1874,49.4,1843,48.6,1637,43.2,631,631,474,75.1,1250,1250,850,68.0
13275,35133,35133,20357,57.9,20287,57.7,18645,53.1,1642,4.7,70,0.2,14776,42.1,20287,20287,(X),8.1,18811,18811,10144,53.9,10131,53.9,9202,48.9,3167,3167,2377,75.1,6570,6570,5240,79.8
13277,31406,31406,18676,59.5,18663,59.4,18126,57.7,537,1.7,13,0.0,12730,40.5,18663,18663,(X),2.9,16535,16535,9271,56.1,9271,56.1,8970,54.2,3272,3272,2029,62.0,5974,5974,4435,74.2
13279,20598,20598,11798,57.3,11752,57.1,10541,51.2,1211,5.9,46,0.2,8800,42.7,11752,11752,(X),10.3,10982,10982,5683,51.7,5683,51.7,5180,47.2,2075,2075,1452,70.0,4506,4506,2934,65.1
13281,10137,10137,4525,44.6,4513,44.5,4267,42.1,246,2.4,12,0.1,5612,55.4,4513,4513,(X),5.5,5445,5445,2398,44.0,2386,43.8,2247,41.3,362,362,259,71.5,941,941,644,68.4
13283,5376,5376,2676,49.8,2676,49.8,2523,46.9,153,2.8,0,0.0,2700,50.2,2676,2676,(X),5.7,2516,2516,1134,45.1,1134,45.1,1054,41.9,562,562,384,68.3,929,929,488,52.5
13285,54233,54233,32400,59.7,32374,59.7,29824,55.0,2550,4.7,26,0.0,21833,40.3,32374,32374,(X),7.9,28624,28624,16170,56.5,16170,56.5,14863,51.9,4954,4954,3589,72.4,11135,11135,8773,78.8
13287,6226,6226,3324,53.4,3324,53.4,3120,50.1,204,3.3,0,0.0,2902,46.6,3324,3324,(X),6.1,3205,3205,1562,48.7,1562,48.7,1460,45.6,555,555,448,80.7,1308,1308,900,68.8
13289,6863,6863,2856,41.6,2844,41.4,2647,38.6,197,2.9,12,0.2,4007,58.4,2844,2844,(X),6.9,3556,3556,1359,38.2,1359,38.2,1252,35.2,416,416,233,56.0,972,972,738,75.9
13291,19369,19369,8438,43.6,8432,43.5,8119,41.9,313,1.6,6,0.0,10931,56.4,8432,8432,(X),3.7,10086,10086,4161,41.3,4161,41.3,3923,38.9,1151,1151,809,70.3,2384,2384,1364,57.2
13293,20875,20875,10895,52.2,10895,52.2,10005,47.9,890,4.3,0,0.0,9980,47.8,10895,10895,(X),8.2,11069,11069,5608,50.7,5608,50.7,5076,45.9,2023,2023,1516,74.9,3488,3488,2698,77.4
13295,55487,55487,31525,56.8,31391,56.6,29376,52.9,2015,3.6,134,0.2,23962,43.2,31391,31391,(X),6.4,28406,28406,14893,52.4,14893,52.4,13899,48.9,4347,4347,2709,62.3,9597,9597,6689,69.7
13297,69892,69892,43065,61.6,42998,61.5,40399,57.8,2599,3.7,67,0.1,26827,38.4,42998,42998,(X),6.0,36329,36329,19943,54.9,19943,54.9,18669,51.4,6630,6630,4475,67.5,14626,14626,10161,69.5
13299,27971,27971,13672,48.9,13672,48.9,13200,47.2,472,1.7,0,0.0,14299,51.1,13672,13672,(X),3.5,14137,14137,6441,45.6,6441,45.6,6164,43.6,2617,2617,1557,59.5,4809,4809,3264,67.9
13301,4335,4335,2354,54.3,2354,54.3,2165,49.9,189,4.4,0,0.0,1981,45.7,2354,2354,(X),8.0,2335,2335,1166,49.9,1166,49.9,1120,48.0,280,280,215,76.8,712,712,539,75.7
13303,16439,16439,8117,49.4,8100,49.3,7504,45.6,596,3.6,17,0.1,8322,50.6,8100,8100,(X),7.4,8169,8169,4199,51.4,4199,51.4,3845,47.1,1286,1286,922,71.7,2789,2789,1980,71.0
13305,23173,23173,11513,49.7,11482,49.5,10612,45.8,870,3.8,31,0.1,11660,50.3,11482,11482,(X),7.6,11408,11408,5378,47.1,5378,47.1,5044,44.2,2002,2002,1378,68.8,4703,4703,2989,63.6
13307,2043,2043,1082,53.0,1082,53.0,1058,51.8,24,1.2,0,0.0,961,47.0,1082,1082,(X),2.2,1091,1091,534,48.9,534,48.9,510,46.7,112,112,91,81.3,480,480,262,54.6
13309,6739,6739,2167,32.2,2167,32.2,1928,28.6,239,3.5,0,0.0,4572,67.8,2167,2167,(X),11.0,2366,2366,878,37.1,878,37.1,779,32.9,406,406,114,28.1,715,715,475,66.4
13311,23985,23985,12875,53.7,12833,53.5,12294,51.3,539,2.2,42,0.2,11110,46.3,12833,12833,(X),4.2,12333,12333,5834,47.3,5834,47.3,5543,44.9,1866,1866,1115,59.8,3578,3578,2487,69.5
13313,79887,79887,50425,63.1,50425,63.1,47247,59.1,3178,4.0,0,0.0,29462,36.9,50425,50425,(X),6.3,40512,40512,22501,55.5,22501,55.5,20765,51.3,8001,8001,5051,63.1,17857,17857,12249,68.6
13315,7322,7322,2601,35.5,2601,35.5,2418,33.0,183,2.5,0,0.0,4721,64.5,2601,2601,(X),7.0,2874,2874,1188,41.3,1188,41.3,1129,39.3,576,576,377,65.5,1059,1059,739,69.8
13317,8063,8063,4255,52.8,4217,52.3,4035,50.0,182,2.3,38,0.5,3808,47.2,4217,4217,(X),4.3,4244,4244,2046,48.2,2046,48.2,1935,45.6,599,599,330,55.1,1218,1218,1010,82.9
13319,7196,7196,3511,48.8,3511,48.8,3258,45.3,253,3.5,0,0.0,3685,51.2,3511,3511,(X),7.2,3825,3825,1741,45.5,1741,45.5,1657,43.3,552,552,330,59.8,1340,1340,898,67.0
13321,16426,16426,9410,57.3,9410,57.3,8801,53.6,609,3.7,0,0.0,7016,42.7,9410,9410,(X),6.5,8570,8570,4233,49.4,4233,49.4,3960,46.2,1348,1348,1119,83.0,3100,3100,2376,76.6
15001,159370,159370,92215,57.9,91970,57.7,86515,54.3,5455,3.4,245,0.2,67155,42.1,91970,91970,(X),5.9,80564,80564,44988,55.8,44931,55.8,42248,52.4,13760,13760,8337,60.6,26424,26424,19724,74.6
15003,798404,798404,531160,66.5,491936,61.6,470748,59.0,21188,2.7,39224,4.9,267244,33.5,491936,491936,(X),4.3,397845,397845,240404,60.4,235762,59.3,226154,56.8,71291,71291,43718,61.3,127026,127026,91858,72.3
15005,71,71,57,80.3,57,80.3,57,80.3,0,0.0,0,0.0,14,19.7,57,57,(X),0.0,35,35,26,74.3,26,74.3,26,74.3,0,0,0,-,0,0,0,-
15007,57366,57366,37816,65.9,37621,65.6,36129,63.0,1492,2.6,195,0.3,19550,34.1,37621,37621,(X),4.0,29202,29202,18509,63.4,18459,63.2,17847,61.1,5323,5323,3823,71.8,9354,9354,7754,82.9
15009,132234,132234,88279,66.8,87898,66.5,83997,63.5,3901,3.0,381,0.3,43955,33.2,87898,87898,(X),4.4,66962,66962,42987,64.2,42913,64.1,41137,61.4,11352,11352,8294,73.1,22161,22161,17536,79.1
16001,350351,350351,231159,66.0,230101,65.7,221254,63.2,8847,2.5,1058,0.3,119192,34.0,230101,230101,(X),3.8,175985,175985,108166,61.5,107913,61.3,103725,58.9,31770,31770,20099,63.3,74124,74124,53920,72.7
16003,3387,3387,1707,50.4,1707,50.4,1517,44.8,190,5.6,0,0.0,1680,49.6,1707,1707,(X),11.1,1613,1613,763,47.3,763,47.3,691,42.8,168,168,71,42.3,533,533,342,64.2
16005,64963,64963,39477,60.8,39410,60.7,36974,56.9,2436,3.7,67,0.1,25486,39.2,39410,39410,(X),6.2,32785,32785,18404,56.1,18404,56.1,17371,53.0,7355,7355,4025,54.7,14326,14326,9344,65.2
16007,4551,4551,2595,57.0,2595,57.0,2514,55.2,81,1.8,0,0.0,1956,43.0,2595,2595,(X),3.1,2357,2357,1159,49.2,1159,49.2,1138,48.3,543,543,303,55.8,995,995,646,64.9
16009,7206,7206,3759,52.2,3759,52.2,3429,47.6,330,4.6,0,0.0,3447,47.8,3759,3759,(X),8.8,3555,3555,1750,49.2,1750,49.2,1581,44.5,561,561,393,70.1,1387,1387,923,66.5
16011,32779,32779,20620,62.9,20567,62.7,19674,60.0,893,2.7,53,0.2,12159,37.1,20567,20567,(X),4.3,16509,16509,9266,56.1,9266,56.1,8874,53.8,4386,4386,2507,57.2,9432,9432,5808,61.6
16013,17744,17744,12682,71.5,12682,71.5,12435,70.1,247,1.4,0,0.0,5062,28.5,12682,12682,(X),1.9,8692,8692,5779,66.5,5779,66.5,5577,64.2,1449,1449,1133,78.2,3336,3336,2536,76.0
16015,6106,6106,3060,50.1,3054,50.0,2858,46.8,196,3.2,6,0.1,3046,49.9,3054,3054,(X),6.4,2871,2871,1323,46.1,1317,45.9,1218,42.4,238,238,93,39.1,903,903,657,72.8
16017,35274,35274,18373,52.1,18371,52.1,17690,50.2,681,1.9,2,0.0,16901,47.9,18371,18371,(X),3.7,17797,17797,8421,47.3,8421,47.3,8099,45.5,2303,2303,1159,50.3,5674,5674,3585,63.2
16019,81028,81028,51379,63.4,51326,63.3,49395,61.0,1931,2.4,53,0.1,29649,36.6,51326,51326,(X),3.8,40896,40896,22060,53.9,22046,53.9,21135,51.7,11396,11396,5499,48.3,22316,22316,13148,58.9
16021,9200,9200,4581,49.8,4581,49.8,4401,47.8,180,2.0,0,0.0,4619,50.2,4581,4581,(X),3.9,4646,4646,1962,42.2,1962,42.2,1886,40.6,819,819,201,24.5,1699,1699,726,42.7
16023,2076,2076,1027,49.5,1027,49.5,967,46.6,60,2.9,0,0.0,1049,50.5,1027,1027,(X),5.8,985,985,402,40.8,402,40.8,395,40.1,129,129,53,41.1,444,444,229,51.6
16025,681,681,394,57.9,394,57.9,382,56.1,12,1.8,0,0.0,287,42.1,394,394,(X),3.0,344,344,152,44.2,152,44.2,152,44.2,66,66,25,37.9,155,155,70,45.2
16027,156717,156717,98216,62.7,98012,62.5,91663,58.5,6349,4.1,204,0.1,58501,37.3,98012,98012,(X),6.5,80073,80073,44969,56.2,44890,56.1,42078,52.5,19119,19119,10283,53.8,40213,40213,26380,65.6
16029,5094,5094,3075,60.4,3075,60.4,3011,59.1,64,1.3,0,0.0,2019,39.6,3075,3075,(X),2.1,2493,2493,1159,46.5,1159,46.5,1146,46.0,558,558,235,42.1,1336,1336,820,61.4
16031,16792,16792,10497,62.5,10477,62.4,10138,60.4,339,2.0,20,0.1,6295,37.5,10477,10477,(X),3.2,8283,8283,4227,51.0,4227,51.0,4111,49.6,2397,2397,1278,53.3,5067,5067,3429,67.7
16033,790,790,502,63.5,502,63.5,463,58.6,39,4.9,0,0.0,288,36.5,502,502,(X),7.8,385,385,190,49.4,190,49.4,176,45.7,113,113,40,35.4,206,206,114,55.3
16035,7419,7419,3110,41.9,3110,41.9,2939,39.6,171,2.3,0,0.0,4309,58.1,3110,3110,(X),5.5,3290,3290,1479,45.0,1479,45.0,1415,43.0,355,355,178,50.1,978,978,612,62.6
16037,3575,3575,1699,47.5,1699,47.5,1619,45.3,80,2.2,0,0.0,1876,52.5,1699,1699,(X),4.7,1725,1725,758,43.9,758,43.9,711,41.2,153,153,78,51.0,544,544,340,62.5
16039,20375,20375,12806,62.9,10462,51.3,9733,47.8,729,3.6,2344,11.5,7569,37.1,10462,10462,(X),7.0,9610,9610,5148,53.6,4782,49.8,4452,46.3,2501,2501,1161,46.4,3696,3696,2079,56.3
16041,9424,9424,5943,63.1,5943,63.1,5861,62.2,82,0.9,0,0.0,3481,36.9,5943,5943,(X),1.4,4654,4654,2469,53.1,2469,53.1,2440,52.4,1220,1220,548,44.9,3155,3155,1420,45.0
16043,9917,9917,5571,56.2,5567,56.1,5212,52.6,355,3.6,4,0.0,4346,43.8,5567,5567,(X),6.4,4674,4674,2269,48.5,2269,48.5,2067,44.2,950,950,440,46.3,2202,2202,1161,52.7
16045,13580,13580,6967,51.3,6967,51.3,6654,49.0,313,2.3,0,0.0,6613,48.7,6967,6967,(X),4.5,6915,6915,3205,46.3,3205,46.3,3046,44.0,1073,1073,604,56.3,2685,2685,2023,75.3
16047,11463,11463,7293,63.6,7293,63.6,6970,60.8,323,2.8,0,0.0,4170,36.4,7293,7293,(X),4.4,5441,5441,2966,54.5,2966,54.5,2857,52.5,1201,1201,686,57.1,2781,2781,1945,69.9
16049,13491,13491,6613,49.0,6613,49.0,6291,46.6,322,2.4,0,0.0,6878,51.0,6613,6613,(X),4.9,6441,6441,3155,49.0,3155,49.0,2991,46.4,871,871,550,63.1,2230,2230,1486,66.6
16051,19525,19525,13086,67.0,13086,67.0,12485,63.9,601,3.1,0,0.0,6439,33.0,13086,13086,(X),4.6,9616,9616,5385,56.0,5385,56.0,5097,53.0,2887,2887,1577,54.6,6536,6536,3657,56.0
16053,16823,16823,11051,65.7,11051,65.7,10607,63.1,444,2.6,0,0.0,5772,34.3,11051,11051,(X),4.0,8272,8272,4644,56.1,4644,56.1,4440,53.7,2208,2208,1271,57.6,4582,4582,3251,71.0
16055,121743,121743,74408,61.1,74284,61.0,70446,57.9,3838,3.2,124,0.1,47335,38.9,74284,74284,(X),5.2,62273,62273,35282,56.7,35282,56.7,33765,54.2,10368,10368,6244,60.2,23648,23648,16272,68.8
16057,32698,32698,20655,63.2,20630,63.1,19601,59.9,1029,3.1,25,0.1,12043,36.8,20630,20630,(X),5.0,16106,16106,9751,60.5,9751,60.5,9269,57.5,2430,2430,1204,49.5,4654,4654,2897,62.2
16059,6530,6530,3328,51.0,3328,51.0,3212,49.2,116,1.8,0,0.0,3202,49.0,3328,3328,(X),3.5,3235,3235,1538,47.5,1538,47.5,1493,46.2,477,477,261,54.7,912,912,579,63.5
16061,3057,3057,1609,52.6,1609,52.6,1515,49.6,94,3.1,0,0.0,1448,47.4,1609,1609,(X),5.8,1567,1567,774,49.4,774,49.4,724,46.2,236,236,179,75.8,597,597,380,63.7
16063,3890,3890,2573,66.1,2573,66.1,2494,64.1,79,2.0,0,0.0,1317,33.9,2573,2573,(X),3.1,1895,1895,1073,56.6,1073,56.6,1058,55.8,457,457,113,24.7,1103,1103,674,61.1
16065,29165,29165,19239,66.0,19239,66.0,17962,61.6,1277,4.4,0,0.0,9926,34.0,19239,19239,(X),6.6,14517,14517,8589,59.2,8589,59.2,7936,54.7,4359,4359,1612,37.0,6126,6126,3115,50.8
16067,15331,15331,9697,63.3,9675,63.1,9339,60.9,336,2.2,22,0.1,5634,36.7,9675,9675,(X),3.5,7575,7575,4150,54.8,4150,54.8,4043,53.4,1892,1892,978,51.7,3663,3663,2414,65.9
16069,32420,32420,19814,61.1,19814,61.1,18892,58.3,922,2.8,0,0.0,12606,38.9,19814,19814,(X),4.7,16581,16581,9471,57.1,9471,57.1,9085,54.8,2796,2796,1924,68.8,5251,5251,4040,76.9
16071,3219,3219,1791,55.6,1791,55.6,1700,52.8,91,2.8,0,0.0,1428,44.4,1791,1791,(X),5.1,1658,1658,777,46.9,777,46.9,736,44.4,345,345,136,39.4,869,869,610,70.2
16073,8753,8753,5207,59.5,5198,59.4,4964,56.7,234,2.7,9,0.1,3546,40.5,5198,5198,(X),4.5,4270,4270,2222,52.0,2222,52.0,2131,49.9,916,916,472,51.5,1981,1981,1414,71.4
16075,17452,17452,10435,59.8,10435,59.8,9859,56.5,576,3.3,0,0.0,7017,40.2,10435,10435,(X),5.5,8819,8819,4582,52.0,4582,52.0,4365,49.5,1589,1589,805,50.7,4017,4017,2473,61.6
16077,5670,5670,3349,59.1,3349,59.1,3218,56.8,131,2.3,0,0.0,2321,40.9,3349,3349,(X),3.9,2795,2795,1195,42.8,1195,42.8,1075,38.5,730,730,205,28.1,1558,1558,773,49.6
16079,10352,10352,5326,51.4,5326,51.4,4866,47.0,460,4.4,0,0.0,5026,48.6,5326,5326,(X),8.6,5203,5203,2293,44.1,2293,44.1,2157,41.5,835,835,381,45.6,1441,1441,908,63.0
16081,8382,8382,6059,72.3,6059,72.3,5698,68.0,361,4.3,0,0.0,2323,27.7,6059,6059,(X),6.0,3914,3914,2516,64.3,2516,64.3,2442,62.4,1000,1000,577,57.7,1888,1888,1252,66.3
16083,62934,62934,41136,65.4,41073,65.3,39657,63.0,1416,2.2,63,0.1,21798,34.6,41073,41073,(X),3.4,32335,32335,19008,58.8,19008,58.8,18365,56.8,7216,7216,4272,59.2,15180,15180,10247,67.5
16085,8695,8695,4305,49.5,4305,49.5,4118,47.4,187,2.2,0,0.0,4390,50.5,4305,4305,(X),4.3,4162,4162,2141,51.4,2141,51.4,2053,49.3,521,521,416,79.8,1290,1290,977,75.7
16087,7915,7915,4257,53.8,4254,53.7,4024,50.8,230,2.9,3,0.0,3658,46.2,4254,4254,(X),5.4,4021,4021,1993,49.6,1993,49.6,1846,45.9,587,587,397,67.6,1684,1684,1316,78.1
17001,53065,53065,34121,64.3,34121,64.3,32501,61.2,1620,3.1,0,0.0,18944,35.7,34121,34121,(X),4.7,27476,27476,16637,60.6,16637,60.6,15867,57.7,4978,4978,3828,76.9,9248,9248,7256,78.5
17003,5077,5077,2385,47.0,2385,47.0,2218,43.7,167,3.3,0,0.0,2692,53.0,2385,2385,(X),7.0,2670,2670,1169,43.8,1169,43.8,1132,42.4,529,529,301,56.9,859,859,601,70.0
17005,13997,13997,7812,55.8,7782,55.6,7481,53.4,301,2.2,30,0.2,6185,44.2,7782,7782,(X),3.9,6834,6834,3945,57.7,3932,57.5,3824,56.0,855,855,590,69.0,2199,2199,1719,78.2
17007,41526,41526,27675,66.6,27636,66.6,25748,62.0,1888,4.5,39,0.1,13851,33.4,27636,27636,(X),6.8,20987,20987,12583,60.0,12583,60.0,11760,56.0,3631,3631,2719,74.9,9529,9529,7130,74.8
17009,5736,5736,2559,44.6,2559,44.6,2448,42.7,111,1.9,0,0.0,3177,55.4,2559,2559,(X),4.3,1973,1973,1246,63.2,1246,63.2,1186,60.1,311,311,276,88.7,707,707,519,73.4
17011,26980,26980,16940,62.8,16929,62.7,16029,59.4,900,3.3,11,0.0,10040,37.2,16929,16929,(X),5.3,13777,13777,7909,57.4,7909,57.4,7518,54.6,1978,1978,1437,72.6,4922,4922,3633,73.8
17013,3970,3970,2157,54.3,2157,54.3,2047,51.6,110,2.8,0,0.0,1813,45.7,2157,2157,(X),5.1,2007,2007,1039,51.8,1039,51.8,1017,50.7,245,245,209,85.3,692,692,562,81.2
17015,12057,12057,7064,58.6,7062,58.6,6595,54.7,467,3.9,2,0.0,4993,41.4,7062,7062,(X),6.6,6088,6088,3291,54.1,3289,54.0,3072,50.5,855,855,704,82.3,1841,1841,1327,72.1
17017,10007,10007,6556,65.5,6544,65.4,6130,61.3,414,4.1,12,0.1,3451,34.5,6544,6544,(X),6.3,5059,5059,3100,61.3,3096,61.2,2947,58.3,1139,1139,890,78.1,1727,1727,1370,79.3
17019,174427,174427,108838,62.4,108722,62.3,103515,59.3,5207,3.0,116,0.1,65589,37.6,108722,108722,(X),4.8,87562,87562,52052,59.4,52052,59.4,49849,56.9,13328,13328,9763,73.3,24041,24041,18799,78.2
17021,27144,27144,15498,57.1,15495,57.1,14965,55.1,530,2.0,3,0.0,11646,42.9,15495,15495,(X),3.4,13457,13457,7566,56.2,7563,56.2,7328,54.5,1882,1882,1460,77.6,4504,4504,3491,77.5
17023,12575,12575,8299,66.0,8299,66.0,7773,61.8,526,4.2,0,0.0,4276,34.0,8299,8299,(X),6.3,6408,6408,3904,60.9,3904,60.9,3610,56.3,1095,1095,758,69.2,2271,2271,1894,83.4
17025,10640,10640,6448,60.6,6448,60.6,6093,57.3,355,3.3,0,0.0,4192,39.4,6448,6448,(X),5.5,5433,5433,3128,57.6,3128,57.6,2968,54.6,943,943,771,81.8,1889,1889,1649,87.3
17027,30668,30668,19378,63.2,19359,63.1,18709,61.0,650,2.1,19,0.1,11290,36.8,19359,19359,(X),3.4,14792,14792,9514,64.3,9514,64.3,9178,62.0,2484,2484,2110,84.9,5364,5364,4239,79.0
17029,43535,43535,26520,60.9,26506,60.9,24987,57.4,1519,3.5,14,0.0,17015,39.1,26506,26506,(X),5.7,22704,22704,13107,57.7,13107,57.7,12432,54.8,2779,2779,1985,71.4,6163,6163,4849,78.7
17031,4192372,4192372,2765106,66.0,2763828,65.9,2548996,60.8,214832,5.1,1278,0.0,1427266,34.0,2763828,2763828,(X),7.8,2182686,2182686,1325131,60.7,1324995,60.7,1222217,56.0,376162,376162,252098,67.0,736602,736602,522777,71.0
17033,15653,15653,8457,54.0,8457,54.0,8000,51.1,457,2.9,0,0.0,7196,46.0,8457,8457,(X),5.4,7466,7466,4151,55.6,4151,55.6,3936,52.7,1082,1082,710,65.6,2549,2549,1981,77.7
17035,8665,8665,5454,62.9,5454,62.9,5270,60.8,184,2.1,0,0.0,3211,37.1,5454,5454,(X),3.4,4357,4357,2496,57.3,2496,57.3,2449,56.2,770,770,584,75.8,1621,1621,1267,78.2
17037,84076,84076,56673,67.4,56668,67.4,52449,62.4,4219,5.0,5,0.0,27403,32.6,56668,56668,(X),7.4,42732,42732,27424,64.2,27424,64.2,25466,59.6,6816,6816,4640,68.1,15099,15099,11272,74.7
17039,13024,13024,8614,66.1,8591,66.0,8119,62.3,472,3.6,23,0.2,4410,33.9,8591,8591,(X),5.5,6521,6521,3809,58.4,3798,58.2,3631,55.7,1152,1152,883,76.6,2228,2228,1684,75.6
17041,15303,15303,9805,64.1,9805,64.1,9382,61.3,423,2.8,0,0.0,5498,35.9,9805,9805,(X),4.3,7882,7882,4350,55.2,4350,55.2,4139,52.5,1481,1481,783,52.9,3237,3237,1781,55.0
17043,742562,742562,513461,69.1,513180,69.1,489858,66.0,23322,3.1,281,0.0,229101,30.9,513180,513180,(X),4.5,381989,381989,238229,62.4,238218,62.4,227341,59.5,65482,65482,43862,67.0,144194,144194,101693,70.5
17045,14381,14381,8839,61.5,8839,61.5,8306,57.8,533,3.7,0,0.0,5542,38.5,8839,8839,(X),6.0,7367,7367,4196,57.0,4196,57.0,3983,54.1,1023,1023,819,80.1,2401,2401,2003,83.4
17047,5228,5228,3239,62.0,3239,62.0,3043,58.2,196,3.7,0,0.0,1989,38.0,3239,3239,(X),6.1,2627,2627,1499,57.1,1499,57.1,1408,53.6,438,438,352,80.4,941,941,743,79.0
17049,26964,26964,18059,67.0,18053,67.0,17344,64.3,709,2.6,6,0.0,8905,33.0,18053,18053,(X),3.9,13683,13683,8127,59.4,8122,59.4,7893,57.7,2565,2565,1809,70.5,5104,5104,3976,77.9
17051,17712,17712,9274,52.4,9274,52.4,8627,48.7,647,3.7,0,0.0,8438,47.6,9274,9274,(X),7.0,8186,8186,4501,55.0,4501,55.0,4268,52.1,1273,1273,904,71.0,2877,2877,1985,69.0
17053,10736,10736,6618,61.6,6617,61.6,6264,58.3,353,3.3,1,0.0,4118,38.4,6617,6617,(X),5.3,5533,5533,3164,57.2,3164,57.2,2929,52.9,1036,1036,776,74.9,1930,1930,1497,77.6
17055,31363,31363,16966,54.1,16966,54.1,15528,49.5,1438,4.6,0,0.0,14397,45.9,16966,16966,(X),8.5,16266,16266,8090,49.7,8090,49.7,7553,46.4,2354,2354,1493,63.4,5498,5498,3547,64.5
17057,29199,29199,16170,55.4,16162,55.4,15077,51.6,1085,3.7,8,0.0,13029,44.6,16162,16162,(X),6.7,13974,13974,7779,55.7,7779,55.7,7337,52.5,2027,2027,1558,76.9,4729,4729,3690,78.0
17059,4209,4209,2240,53.2,2240,53.2,2139,50.8,101,2.4,0,0.0,1969,46.8,2240,2240,(X),4.5,2186,2186,1014,46.4,1014,46.4,979,44.8,329,329,180,54.7,640,640,474,74.1
17061,10840,10840,6275,57.9,6275,57.9,6026,55.6,249,2.3,0,0.0,4565,42.1,6275,6275,(X),4.0,5346,5346,3037,56.8,3037,56.8,2928,54.8,803,803,597,74.3,1768,1768,1381,78.1
17063,39016,39016,26392,67.6,26379,67.6,25041,64.2,1338,3.4,13,0.0,12624,32.4,26379,26379,(X),5.1,19852,19852,12305,62.0,12297,61.9,11707,59.0,3848,3848,2792,72.6,8426,8426,6593,78.2
17065,6595,6595,3762,57.0,3754,56.9,3635,55.1,119,1.8,8,0.1,2833,43.0,3754,3754,(X),3.2,3393,3393,1630,48.0,1630,48.0,1581,46.6,549,549,388,70.7,1218,1218,952,78.2
17067,14781,14781,8681,58.7,8663,58.6,8127,55.0,536,3.6,18,0.1,6100,41.3,8663,8663,(X),6.2,7551,7551,3916,51.9,3916,51.9,3672,48.6,1135,1135,829,73.0,2502,2502,1902,76.0
17069,3399,3399,1640,48.2,1640,48.2,1379,40.6,261,7.7,0,0.0,1759,51.8,1640,1640,(X),15.9,1699,1699,727,42.8,727,42.8,641,37.7,155,155,92,59.4,483,483,387,80.1
17071,5780,5780,3462,59.9,3457,59.8,3262,56.4,195,3.4,5,0.1,2318,40.1,3457,3457,(X),5.6,2957,2957,1591,53.8,1591,53.8,1503,50.8,380,380,247,65.0,845,845,725,85.8
17073,39649,39649,24175,61.0,24147,60.9,22904,57.8,1243,3.1,28,0.1,15474,39.0,24147,24147,(X),5.1,20128,20128,11152,55.4,11152,55.4,10546,52.4,3234,3234,2142,66.2,7471,7471,5538,74.1
17075,22790,22790,14045,61.6,14045,61.6,13260,58.2,785,3.4,0,0.0,8745,38.4,14045,14045,(X),5.6,11758,11758,6676,56.8,6676,56.8,6346,54.0,1642,1642,1273,77.5,4183,4183,3062,73.2
17077,49055,49055,27692,56.5,27672,56.4,25059,51.1,2613,5.3,20,0.0,21363,43.5,27672,27672,(X),9.4,24677,24677,13757,55.7,13757,55.7,12343,50.0,3463,3463,2071,59.8,6445,6445,4943,76.7
17079,7648,7648,4633,60.6,4626,60.5,4438,58.0,188,2.5,7,0.1,3015,39.4,4626,4626,(X),4.1,3865,3865,2174,56.2,2174,56.2,2147,55.5,620,620,406,65.5,1315,1315,1040,79.1
17081,30543,30543,17439,57.1,17434,57.1,16150,52.9,1284,4.2,5,0.0,13104,42.9,17434,17434,(X),7.4,14809,14809,8498,57.4,8498,57.4,7941,53.6,2810,2810,2015,71.7,5092,5092,3866,75.9
17083,18079,18079,11127,61.5,11126,61.5,10675,59.0,451,2.5,1,0.0,6952,38.5,11126,11126,(X),4.1,9291,9291,5409,58.2,5409,58.2,5202,56.0,1165,1165,880,75.5,3314,3314,2553,77.0
17085,18178,18178,11232,61.8,11225,61.8,10723,59.0,502,2.8,7,0.0,6946,38.2,11225,11225,(X),4.5,9172,9172,5236,57.1,5236,57.1,4994,54.4,1133,1133,948,83.7,2856,2856,2360,82.6
17087,10603,10603,4128,38.9,4113,38.8,3878,36.6,235,2.2,15,0.1,6475,61.1,4113,4113,(X),5.7,4592,4592,2231,48.6,2231,48.6,2108,45.9,691,691,529,76.6,1443,1443,1092,75.7
17089,408624,408624,281764,69.0,281637,68.9,266113,65.1,15524,3.8,127,0.0,126860,31.0,281637,281637,(X),5.5,206784,206784,129126,62.4,129082,62.4,121184,58.6,40933,40933,27060,66.1,93876,93876,66966,71.3
17091,88188,88188,53832,61.0,53770,61.0,50539,57.3,3231,3.7,62,0.1,34356,39.0,53770,53770,(X),6.0,45223,45223,25783,57.0,25782,57.0,24392,53.9,7814,7814,5049,64.6,16806,16806,12341,73.4
17093,92166,92166,67387,73.1,67354,73.1,64083,69.5,3271,3.5,33,0.0,24779,26.9,67354,67354,(X),4.9,47299,47299,31626,66.9,31626,66.9,30084,63.6,10417,10417,6722,64.5,24920,24920,16659,66.8
17095,42036,42036,22546,53.6,22512,53.6,21236,50.5,1276,3.0,34,0.1,19490,46.4,22512,22512,(X),5.7,21021,21021,11086,52.7,11083,52.7,10497,49.9,3081,3081,1940,63.0,6034,6034,4580,75.9
17097,551056,551056,381084,69.2,371346,67.4,350731,63.6,20615,3.7,9738,1.8,169972,30.8,371346,371346,(X),5.6,277486,277486,172833,62.3,171192,61.7,161873,58.3,49556,49556,33688,68.0,119874,119874,86146,71.9
17099,89496,89496,55162,61.6,55099,61.6,51365,57.4,3734,4.2,63,0.1,34334,38.4,55099,55099,(X),6.8,44672,44672,25850,57.9,25828,57.8,24526,54.9,7344,7344,5142,70.0,15625,15625,11272,72.1
17101,13388,13388,6760,50.5,6760,50.5,6333,47.3,427,3.2,0,0.0,6628,49.5,6760,6760,(X),6.3,5843,5843,3272,56.0,3272,56.0,3163,54.1,1062,1062,630,59.3,1983,1983,1359,68.5
17103,28503,28503,16172,56.7,16166,56.7,15455,54.2,711,2.5,6,0.0,12331,43.3,16166,16166,(X),4.4,13241,13241,7720,58.3,7717,58.3,7455,56.3,2067,2067,1647,79.7,4413,4413,3626,82.2
17105,29585,29585,17236,58.3,17214,58.2,16284,55.0,930,3.1,22,0.1,12349,41.7,17214,17214,(X),5.4,14447,14447,8071,55.9,8071,55.9,7612,52.7,2275,2275,1426,62.7,5031,5031,3832,76.2
17107,24259,24259,13201,54.4,13200,54.4,12456,51.3,744,3.1,1,0.0,11058,45.6,13200,13200,(X),5.6,12644,12644,6034,47.7,6034,47.7,5701,45.1,1751,1751,1199,68.5,3631,3631,2863,78.8
17109,26296,26296,14589,55.5,14577,55.4,13464,51.2,1113,4.2,12,0.0,11707,44.5,14577,14577,(X),7.6,13701,13701,7302,53.3,7302,53.3,6683,48.8,1624,1624,1338,82.4,3288,3288,2664,81.0
17111,243163,243163,171051,70.3,171036,70.3,163471,67.2,7565,3.1,15,0.0,72112,29.7,171036,171036,(X),4.4,123100,123100,79282,64.4,79282,64.4,75898,61.7,19906,19906,13280,66.7,51836,51836,39068,75.4
17113,139889,139889,93765,67.0,93704,67.0,90407,64.6,3297,2.4,61,0.0,46124,33.0,93704,93704,(X),3.5,72418,72418,45743,63.2,45721,63.1,44271,61.1,12178,12178,8064,66.2,24188,24188,18083,74.8
17115,85368,85368,52181,61.1,52138,61.1,47876,56.1,4262,5.0,43,0.1,33187,38.9,52138,52138,(X),8.2,45085,45085,25962,57.6,25962,57.6,24137,53.5,7515,7515,5776,76.9,15131,15131,11885,78.5
17117,37154,37154,22251,59.9,22223,59.8,20652,55.6,1571,4.2,28,0.1,14903,40.1,22223,22223,(X),7.1,19221,19221,10696,55.6,10696,55.6,10063,52.4,2673,2673,1840,68.8,6525,6525,4973,76.2
17119,213951,213951,135194,63.2,134969,63.1,125733,58.8,9236,4.3,225,0.1,78757,36.8,134969,134969,(X),6.8,111056,111056,65244,58.7,65185,58.7,61030,55.0,18269,18269,13232,72.4,37128,37128,28321,76.3
17121,30162,30162,18482,61.3,18470,61.2,16723,55.4,1747,5.8,12,0.0,11680,38.7,18470,18470,(X),9.5,15534,15534,8946,57.6,8946,57.6,8077,52.0,2788,2788,2153,77.2,5300,5300,4045,76.3
17123,9733,9733,5752,59.1,5752,59.1,5404,55.5,348,3.6,0,0.0,3981,40.9,5752,5752,(X),6.1,4924,4924,2702,54.9,2702,54.9,2552,51.8,747,747,537,71.9,1452,1452,1081,74.4
17125,11283,11283,6699,59.4,6688,59.3,6162,54.6,526,4.7,11,0.1,4584,40.6,6688,6688,(X),7.9,5722,5722,3110,54.4,3110,54.4,2837,49.6,807,807,490,60.7,1841,1841,1498,81.4
17127,11555,11555,5949,51.5,5949,51.5,5617,48.6,332,2.9,0,0.0,5606,48.5,5949,5949,(X),5.6,6071,6071,2859,47.1,2859,47.1,2707,44.6,981,981,625,63.7,2145,2145,1578,73.6
17129,9948,9948,6412,64.5,6392,64.3,6077,61.1,315,3.2,20,0.2,3536,35.5,6392,6392,(X),4.9,5156,5156,3141,60.9,3141,60.9,2998,58.1,834,834,644,77.2,1716,1716,1294,75.4
17131,12685,12685,7828,61.7,7821,61.7,7392,58.3,429,3.4,7,0.1,4857,38.3,7821,7821,(X),5.5,6384,6384,3692,57.8,3692,57.8,3525,55.2,1003,1003,548,54.6,2295,2295,1999,87.1
17133,27189,27189,18508,68.1,18485,68.0,17910,65.9,575,2.1,23,0.1,8681,31.9,18485,18485,(X),3.1,14003,14003,9136,65.2,9136,65.2,8800,62.8,2171,2171,1745,80.4,5433,5433,4622,85.1
17135,23989,23989,11821,49.3,11819,49.3,11245,46.9,574,2.4,2,0.0,12168,50.7,11819,11819,(X),4.9,11411,11411,5989,52.5,5989,52.5,5688,49.8,1647,1647,1233,74.9,3739,3739,2739,73.3
17137,28668,28668,16660,58.1,16643,58.1,15653,54.6,990,3.5,17,0.1,12008,41.9,16643,16643,(X),5.9,14270,14270,8364,58.6,8364,58.6,7997,56.0,1982,1982,1511,76.2,4180,4180,3283,78.5
17139,11385,11385,7182,63.1,7155,62.8,6925,60.8,230,2.0,27,0.2,4203,36.9,7155,7155,(X),3.2,5873,5873,3103,52.8,3103,52.8,3008,51.2,1112,1112,513,46.1,2523,2523,1385,54.9
17141,41113,41113,26447,64.3,26444,64.3,24879,60.5,1565,3.8,3,0.0,14666,35.7,26444,26444,(X),5.9,20777,20777,12376,59.6,12376,59.6,11646,56.1,3137,3137,2172,69.2,7972,7972,5725,71.8
17143,145286,145286,90508,62.3,90385,62.2,83236,57.3,7149,4.9,123,0.1,54778,37.7,90385,90385,(X),7.9,76009,76009,44616,58.7,44586,58.7,41661,54.8,14305,14305,9755,68.2,27359,27359,20541,75.1
17145,17790,17790,8585,48.3,8572,48.2,7988,44.9,584,3.3,13,0.1,9205,51.7,8572,8572,(X),6.8,7818,7818,3972,50.8,3972,50.8,3652,46.7,1328,1328,780,58.7,2589,2589,1874,72.4
17147,13213,13213,8957,67.8,8947,67.7,8575,64.9,372,2.8,10,0.1,4256,32.2,8947,8947,(X),4.2,6706,6706,4298,64.1,4298,64.1,4173,62.2,1077,1077,711,66.0,2419,2419,1897,78.4
17149,12592,12592,7330,58.2,7330,58.2,6935,55.1,395,3.1,0,0.0,5262,41.8,7330,7330,(X),5.4,6403,6403,3355,52.4,3355,52.4,3196,49.9,1108,1108,853,77.0,2301,2301,1592,69.2
17151,3669,3669,1501,40.9,1501,40.9,1267,34.5,234,6.4,0,0.0,2168,59.1,1501,1501,(X),15.6,1663,1663,566,34.0,566,34.0,499,30.0,178,178,57,32.0,410,410,192,46.8
17153,4545,4545,2055,45.2,2055,45.2,1863,41.0,192,4.2,0,0.0,2490,54.8,2055,2055,(X),9.3,2324,2324,1026,44.1,1026,44.1,925,39.8,341,341,224,65.7,721,721,556,77.1
17155,4777,4777,3107,65.0,3105,65.0,2993,62.7,112,2.3,2,0.0,1670,35.0,3105,3105,(X),3.6,2365,2365,1371,58.0,1371,58.0,1322,55.9,290,290,199,68.6,765,765,546,71.4
17157,26834,26834,13659,50.9,13633,50.8,12944,48.2,689,2.6,26,0.1,13175,49.1,13633,13633,(X),5.1,11813,11813,6244,52.9,6239,52.8,5978,50.6,1748,1748,1312,75.1,4168,4168,3008,72.2
17159,12683,12683,7706,60.8,7706,60.8,7257,57.2,449,3.5,0,0.0,4977,39.2,7706,7706,(X),5.8,6484,6484,3600,55.5,3600,55.5,3390,52.3,1167,1167,848,72.7,2181,2181,1774,81.3
17161,116359,116359,72968,62.7,72903,62.7,68166,58.6,4737,4.1,65,0.1,43391,37.3,72903,72903,(X),6.5,59619,59619,35313,59.2,35313,59.2,33054,55.4,10330,10330,7138,69.1,20503,20503,16368,79.8
17163,208285,208285,131032,62.9,127720,61.3,118602,56.9,9118,4.4,3312,1.6,77253,37.1,127720,127720,(X),7.1,109296,109296,64728,59.2,64041,58.6,59715,54.6,19684,19684,14083,71.5,40140,40140,29989,74.7
17165,19586,19586,10796,55.1,10796,55.1,9736,49.7,1060,5.4,0,0.0,8790,44.9,10796,10796,(X),9.8,10025,10025,5096,50.8,5096,50.8,4670,46.6,1590,1590,1188,74.7,3421,3421,2361,69.0
17167,158347,158347,101894,64.3,101709,64.2,95308,60.2,6401,4.0,185,0.1,56453,35.7,101709,101709,(X),6.3,83399,83399,50798,60.9,50774,60.9,48253,57.9,13429,13429,10419,77.6,28717,28717,23261,81.0
17169,5893,5893,3039,51.6,3039,51.6,2872,48.7,167,2.8,0,0.0,2854,48.4,3039,3039,(X),5.5,2776,2776,1608,57.9,1608,57.9,1523,54.9,335,335,282,84.2,848,848,696,82.1
17171,4067,4067,2512,61.8,2512,61.8,2343,57.6,169,4.2,0,0.0,1555,38.2,2512,2512,(X),6.7,2108,2108,1210,57.4,1210,57.4,1129,53.6,313,313,246,78.6,711,711,588,82.7
17173,17765,17765,10848,61.1,10848,61.1,10347,58.2,501,2.8,0,0.0,6917,38.9,10848,10848,(X),4.6,9051,9051,5079,56.1,5079,56.1,4918,54.3,1345,1345,953,70.9,3020,3020,2393,79.2
17175,4453,4453,2598,58.3,2598,58.3,2508,56.3,90,2.0,0,0.0,1855,41.7,2598,2598,(X),3.5,2234,2234,1147,51.3,1147,51.3,1100,49.2,355,355,210,59.2,797,797,481,60.4
17177,36751,36751,22879,62.3,22853,62.2,21222,57.7,1631,4.4,26,0.1,13872,37.7,22853,22853,(X),7.1,19186,19186,11164,58.2,11164,58.2,10397,54.2,3196,3196,2417,75.6,6171,6171,5068,82.1
17179,106491,106491,66300,62.3,66159,62.1,63328,59.5,2831,2.7,141,0.1,40191,37.7,66159,66159,(X),4.3,54228,54228,31466,58.0,31460,58.0,30315,55.9,9127,9127,6160,67.5,19858,19858,15075,75.9
17181,13956,13956,7657,54.9,7657,54.9,7148,51.2,509,3.6,0,0.0,6299,45.1,7657,7657,(X),6.6,7035,7035,3426,48.7,3426,48.7,3219,45.8,1017,1017,748,73.5,2371,2371,1747,73.7
17183,61864,61864,34131,55.2,34118,55.2,31575,51.0,2543,4.1,13,0.0,27733,44.8,34118,34118,(X),7.5,31382,31382,16625,53.0,16613,52.9,15394,49.1,5781,5781,4105,71.0,11537,11537,8407,72.9
17185,9292,9292,5657,60.9,5657,60.9,5325,57.3,332,3.6,0,0.0,3635,39.1,5657,5657,(X),5.9,4802,4802,2612,54.4,2612,54.4,2489,51.8,864,864,613,70.9,1570,1570,1221,77.8
17187,13924,13924,8669,62.3,8663,62.2,8086,58.1,577,4.1,6,0.0,5255,37.7,8663,8663,(X),6.7,7125,7125,4190,58.8,4190,58.8,3952,55.5,1173,1173,705,60.1,2527,2527,1899,75.1
17189,11410,11410,7437,65.2,7437,65.2,7121,62.4,316,2.8,0,0.0,3973,34.8,7437,7437,(X),4.2,5727,5727,3407,59.5,3407,59.5,3234,56.5,972,972,780,80.2,1903,1903,1560,82.0
17191,13140,13140,7795,59.3,7779,59.2,7507,57.1,272,2.1,16,0.1,5345,40.7,7779,7779,(X),3.5,6659,6659,3460,52.0,3458,51.9,3271,49.1,1172,1172,727,62.0,2439,2439,1787,73.3
17193,11254,11254,6433,57.2,6433,57.2,5926,52.7,507,4.5,0,0.0,4821,42.8,6433,6433,(X),7.9,5814,5814,3033,52.2,3033,52.2,2808,48.3,969,969,629,64.9,1964,1964,1511,76.9
17195,45354,45354,27880,61.5,27864,61.4,26393,58.2,1471,3.2,16,0.0,17474,38.5,27864,27864,(X),5.3,23124,23124,13333,57.7,13321,57.6,12685,54.9,3997,3997,3025,75.7,8013,8013,6350,79.2
17197,533442,533442,367773,68.9,367506,68.9,348560,65.3,18946,3.6,267,0.1,165669,31.1,367506,367506,(X),5.2,270931,270931,171616,63.3,171592,63.3,163084,60.2,49105,49105,33420,68.1,123218,123218,90361,73.3
17199,54017,54017,30742,56.9,30704,56.8,28899,53.5,1805,3.3,38,0.1,23275,43.1,30704,30704,(X),5.9,27135,27135,14779,54.5,14772,54.4,14176,52.2,4457,4457,3258,73.1,9450,9450,7655,81.0
17201,226507,226507,146107,64.5,146055,64.5,132751,58.6,13304,5.9,52,0.0,80400,35.5,146055,146055,(X),9.1,117474,117474,70346,59.9,70346,59.9,64090,54.6,20464,20464,15096,73.8,42530,42530,32697,76.9
17203,30489,30489,19619,64.3,19603,64.3,18800,61.7,803,2.6,16,0.1,10870,35.7,19603,19603,(X),4.1,15512,15512,8933,57.6,8933,57.6,8668,55.9,2800,2800,1818,64.9,6552,6552,4829,73.7
18001,25271,25271,16122,63.8,16122,63.8,15536,61.5,586,2.3,0,0.0,9149,36.2,16122,16122,(X),3.6,12847,12847,7083,55.1,7083,55.1,6822,53.1,3475,3475,1548,44.5,6945,6945,4134,59.5
18003,284667,284667,189778,66.7,189682,66.6,179102,62.9,10580,3.7,96,0.0,94889,33.3,189682,189682,(X),5.6,147460,147460,91398,62.0,91398,62.0,86005,58.3,30806,30806,20656,67.1,60936,60936,44428,72.9
18005,64387,64387,42243,65.6,42234,65.6,40192,62.4,2042,3.2,9,0.0,22144,34.4,42234,42234,(X),4.8,32156,32156,18545,57.7,18545,57.7,17505,54.4,6286,6286,3632,57.8,12373,12373,9302,75.2
18007,6789,6789,4253,62.6,4253,62.6,4073,60.0,180,2.7,0,0.0,2536,37.4,4253,4253,(X),4.2,3504,3504,1914,54.6,1914,54.6,1834,52.3,705,705,395,56.0,1337,1337,788,58.9
18009,9878,9878,5713,57.8,5713,57.8,5348,54.1,365,3.7,0,0.0,4165,42.2,5713,5713,(X),6.4,4997,4997,2654,53.1,2654,53.1,2479,49.6,734,734,490,66.8,1641,1641,1296,79.0
18011,48990,48990,34644,70.7,34553,70.5,33689,68.8,864,1.8,91,0.2,14346,29.3,34553,34553,(X),2.5,25140,25140,16278,64.7,16278,64.7,15913,63.3,5299,5299,3723,70.3,11394,11394,8104,71.1
18013,12713,12713,7371,58.0,7371,58.0,7022,55.2,349,2.7,0,0.0,5342,42.0,7371,7371,(X),4.7,6467,6467,3486,53.9,3486,53.9,3337,51.6,731,731,449,61.4,1836,1836,1197,65.2
18015,15989,15989,9644,60.3,9644,60.3,9242,57.8,402,2.5,0,0.0,6345,39.7,9644,9644,(X),4.2,8080,8080,4270,52.8,4270,52.8,4048,50.1,1294,1294,813,62.8,2881,2881,2033,70.6
18017,30358,30358,18199,59.9,18199,59.9,17098,56.3,1101,3.6,0,0.0,12159,40.1,18199,18199,(X),6.0,15234,15234,8350,54.8,8350,54.8,7896,51.8,2594,2594,1725,66.5,5532,5532,3821,69.1
18019,92307,92307,60832,65.9,60811,65.9,57679,62.5,3132,3.4,21,0.0,31475,34.1,60811,60811,(X),5.2,47885,47885,29544,61.7,29544,61.7,28229,59.0,8410,8410,5543,65.9,16675,16675,12839,77.0
18021,20823,20823,12952,62.2,12904,62.0,12218,58.7,686,3.3,48,0.2,7871,37.8,12904,12904,(X),5.3,10718,10718,6173,57.6,6173,57.6,5740,53.6,1617,1617,1147,70.9,4125,4125,3153,76.4
18023,24742,24742,15914,64.3,15895,64.2,15129,61.1,766,3.1,19,0.1,8828,35.7,15895,15895,(X),4.8,12667,12667,7382,58.3,7382,58.3,6985,55.1,2493,2493,1749,70.2,5304,5304,4107,77.4
18025,8543,8543,4543,53.2,4536,53.1,4361,51.0,175,2.0,7,0.1,4000,46.8,4536,4536,(X),3.9,4194,4194,2007,47.9,2007,47.9,1929,46.0,610,610,392,64.3,1378,1378,1033,75.0
18027,24279,24279,15142,62.4,15137,62.3,14513,59.8,624,2.6,5,0.0,9137,37.6,15137,15137,(X),4.1,12201,12201,6384,52.3,6384,52.3,6128,50.2,3086,3086,1291,41.8,6341,6341,3635,57.3
18029,39589,39589,26084,65.9,26062,65.8,24790,62.6,1272,3.2,22,0.1,13505,34.1,26062,26062,(X),4.9,19920,19920,12245,61.5,12245,61.5,11873,59.6,2978,2978,2131,71.6,7691,7691,6116,79.5
18031,20928,20928,13718,65.5,13718,65.5,13121,62.7,597,2.9,0,0.0,7210,34.5,13718,13718,(X),4.4,10592,10592,6287,59.4,6287,59.4,6014,56.8,2026,2026,1498,73.9,4087,4087,3068,75.1
18033,33598,33598,22395,66.7,22395,66.7,21374,63.6,1021,3.0,0,0.0,11203,33.3,22395,22395,(X),4.6,17052,17052,10360,60.8,10360,60.8,9897,58.0,3032,3032,2188,72.2,6926,6926,5281,76.2
18035,96784,96784,56923,58.8,56883,58.8,53067,54.8,3816,3.9,40,0.0,39861,41.2,56883,56883,(X),6.7,50735,50735,27844,54.9,27844,54.9,26214,51.7,6950,6950,4789,68.9,13305,13305,9107,68.4
18037,33040,33040,22545,68.2,22545,68.2,22194,67.2,351,1.1,0,0.0,10495,31.8,22545,22545,(X),1.6,16808,16808,10446,62.1,10446,62.1,10291,61.2,3401,3401,2799,82.3,6760,6760,5553,82.1
18039,153098,153098,100963,65.9,100940,65.9,96156,62.8,4784,3.1,23,0.0,52135,34.1,100940,100940,(X),4.7,78137,78137,45347,58.0,45347,58.0,42995,55.0,17249,17249,10487,60.8,37035,37035,24635,66.5
18041,18729,18729,10380,55.4,10380,55.4,9858,52.6,522,2.8,0,0.0,8349,44.6,10380,10380,(X),5.0,9599,9599,4804,50.0,4804,50.0,4618,48.1,1269,1269,796,62.7,3298,3298,2532,76.8
18043,61143,61143,40477,66.2,40436,66.1,38611,63.1,1825,3.0,41,0.1,20666,33.8,40436,40436,(X),4.5,31872,31872,19426,61.0,19426,61.0,18446,57.9,5101,5101,3975,77.9,11528,11528,8929,77.5
18045,13266,13266,7965,60.0,7965,60.0,7506,56.6,459,3.5,0,0.0,5301,40.0,7965,7965,(X),5.8,6787,6787,3528,52.0,3528,52.0,3309,48.8,1195,1195,794,66.4,2204,2204,1722,78.1
18047,18118,18118,11559,63.8,11534,63.7,11080,61.2,454,2.5,25,0.1,6559,36.2,11534,11534,(X),3.9,9159,9159,5362,58.5,5362,58.5,5098,55.7,1624,1624,1109,68.3,3615,3615,2887,79.9
18049,15981,15981,10014,62.7,10014,62.7,9557,59.8,457,2.9,0,0.0,5967,37.3,10014,10014,(X),4.6,8165,8165,4589,56.2,4589,56.2,4471,54.8,1510,1510,1038,68.7,2957,2957,2070,70.0
18051,26741,26741,16816,62.9,16812,62.9,16281,60.9,531,2.0,4,0.0,9925,37.1,16812,16812,(X),3.2,13514,13514,7619,56.4,7619,56.4,7420,54.9,2392,2392,1607,67.2,5193,5193,3815,73.5
18053,54539,54539,31356,57.5,31356,57.5,29052,53.3,2304,4.2,0,0.0,23183,42.5,31356,31356,(X),7.3,28827,28827,15521,53.8,15521,53.8,14429,50.1,4309,4309,3043,70.6,8574,8574,5889,68.7
18055,26158,26158,14992,57.3,14966,57.2,14124,54.0,842,3.2,26,0.1,11166,42.7,14966,14966,(X),5.6,13206,13206,6859,51.9,6859,51.9,6495,49.2,2012,2012,1367,67.9,4542,4542,3211,70.7
18057,237540,237540,174019,73.3,173825,73.2,168749,71.0,5076,2.1,194,0.1,63521,26.7,173825,173825,(X),2.9,123241,123241,82453,66.9,82425,66.9,80005,64.9,25844,25844,18152,70.2,60238,60238,45470,75.5
18059,58689,58689,39727,67.7,39727,67.7,38632,65.8,1095,1.9,0,0.0,18962,32.3,39727,39727,(X),2.8,30278,30278,18717,61.8,18717,61.8,18047,59.6,4989,4989,3777,75.7,11865,11865,9589,80.8
18061,31793,31793,18953,59.6,18938,59.6,17765,55.9,1173,3.7,15,0.0,12840,40.4,18938,18938,(X),6.2,16010,16010,8913,55.7,8913,55.7,8532,53.3,2577,2577,1716,66.6,5758,5758,4329,75.2
18063,124765,124765,87623,70.2,87543,70.2,84103,67.4,3440,2.8,80,0.1,37142,29.8,87543,87543,(X),3.9,62809,62809,41273,65.7,41273,65.7,39535,62.9,11298,11298,8088,71.6,28559,28559,23010,80.6
18065,39753,39753,21362,53.7,21353,53.7,20056,50.5,1297,3.3,9,0.0,18391,46.3,21353,21353,(X),6.1,18967,18967,10137,53.4,10137,53.4,9514,50.2,2732,2732,1935,70.8,6549,6549,4667,71.3
18067,66064,66064,39259,59.4,39197,59.3,36898,55.9,2299,3.5,62,0.1,26805,40.6,39197,39197,(X),5.9,34500,34500,18666,54.1,18666,54.1,17651,51.2,5370,5370,3777,70.3,11974,11974,9318,77.8
18069,29367,29367,19017,64.8,19012,64.7,18366,62.5,646,2.2,5,0.0,10350,35.2,19012,19012,(X),3.4,15110,15110,9038,59.8,9038,59.8,8723,57.7,2299,2299,1736,75.5,4970,4970,3899,78.5
18071,34317,34317,21518,62.7,21518,62.7,20533,59.8,985,2.9,0,0.0,12799,37.3,21518,21518,(X),4.6,17407,17407,9941,57.1,9941,57.1,9441,54.2,3316,3316,2281,68.8,6519,6519,4697,72.1
18073,26504,26504,16191,61.1,16188,61.1,15493,58.5,695,2.6,3,0.0,10313,38.9,16188,16188,(X),4.3,13335,13335,7063,53.0,7063,53.0,6754,50.6,2239,2239,1419,63.4,5234,5234,3879,74.1
18075,16188,16188,10031,62.0,10031,62.0,9491,58.6,540,3.3,0,0.0,6157,38.0,10031,10031,(X),5.4,8288,8288,4535,54.7,4535,54.7,4205,50.7,1595,1595,1012,63.4,3359,3359,2449,72.9
18077,26640,26640,15377,57.7,15377,57.7,14454,54.3,923,3.5,0,0.0,11263,42.3,15377,15377,(X),6.0,14089,14089,6941,49.3,6941,49.3,6443,45.7,2086,2086,1442,69.1,4128,4128,3075,74.5
18079,21970,21970,13834,63.0,13789,62.8,13225,60.2,564,2.6,45,0.2,8136,37.0,13789,13789,(X),4.1,10982,10982,6589,60.0,6589,60.0,6332,57.7,1862,1862,1251,67.2,4095,4095,2818,68.8
18081,117868,117868,80191,68.0,79759,67.7,76397,64.8,3362,2.9,432,0.4,37677,32.0,79759,79759,(X),4.2,60801,60801,38330,63.0,38300,63.0,36852,60.6,11699,11699,8391,71.7,24424,24424,19851,81.3
18083,30348,30348,19030,62.7,19030,62.7,18068,59.5,962,3.2,0,0.0,11318,37.3,19030,19030,(X),5.1,15121,15121,8876,58.7,8876,58.7,8369,55.3,2575,2575,1849,71.8,4766,4766,3657,76.7
18085,61734,61734,40893,66.2,40893,66.2,39265,63.6,1628,2.6,0,0.0,20841,33.8,40893,40893,(X),4.0,31143,31143,18293,58.7,18293,58.7,17630,56.6,6020,6020,3845,63.9,11974,11974,8375,69.9
18087,27517,27517,17346,63.0,17333,63.0,16906,61.4,427,1.6,13,0.0,10171,37.0,17333,17333,(X),2.5,13799,13799,6687,48.5,6687,48.5,6397,46.4,4173,4173,903,21.6,8194,8194,2952,36.0
18089,385159,385159,236444,61.4,236341,61.4,217505,56.5,18836,4.9,103,0.0,148715,38.6,236341,236341,(X),8.0,201679,201679,113649,56.4,113649,56.4,105133,52.1,34386,34386,22358,65.0,75619,75619,52730,69.7
18091,89337,89337,50972,57.1,50965,57.0,47006,52.6,3959,4.4,7,0.0,38365,42.9,50965,50965,(X),7.8,43059,43059,24616,57.2,24616,57.2,22808,53.0,7410,7410,4832,65.2,14830,14830,10735,72.4
18093,36711,36711,21529,58.6,21510,58.6,20460,55.7,1050,2.9,19,0.1,15182,41.4,21510,21510,(X),4.9,18807,18807,10139,53.9,10139,53.9,9769,51.9,2966,2966,1856,62.6,6233,6233,4414,70.8
18095,104561,104561,60075,57.5,60053,57.4,56373,53.9,3680,3.5,22,0.0,44486,42.5,60053,60053,(X),6.1,52946,52946,29398,55.5,29398,55.5,27839,52.6,8613,8613,5657,65.7,17258,17258,12300,71.3
18097,733798,733798,492067,67.1,491738,67.0,457060,62.3,34678,4.7,329,0.0,241731,32.9,491738,491738,(X),7.1,386762,386762,244839,63.3,244784,63.3,228011,59.0,78201,78201,53805,68.8,140312,140312,103430,73.7
18099,36171,36171,22661,62.6,22650,62.6,21365,59.1,1285,3.6,11,0.0,13510,37.4,22650,22650,(X),5.7,18350,18350,10455,57.0,10455,57.0,9782,53.3,3342,3342,2131,63.8,7833,7833,5306,67.7
18101,8254,8254,5023,60.9,4855,58.8,4705,57.0,150,1.8,168,2.0,3231,39.1,4855,4855,(X),3.1,4136,4136,2279,55.1,2197,53.1,2174,52.6,614,614,446,72.6,1462,1462,1097,75.0
18103,29163,29163,16388,56.2,16357,56.1,15271,52.4,1086,3.7,31,0.1,12775,43.8,16357,16357,(X),6.6,13553,13553,7127,52.6,7127,52.6,6526,48.2,2199,2199,1372,62.4,4982,4982,3282,65.9
18105,124908,124908,77651,62.2,77560,62.1,72599,58.1,4961,4.0,91,0.1,47257,37.8,77560,77560,(X),6.4,63031,63031,37844,60.0,37837,60.0,35158,55.8,7499,7499,5067,67.6,14342,14342,10464,73.0
18107,30466,30466,19671,64.6,19647,64.5,18836,61.8,811,2.7,24,0.1,10795,35.4,19647,19647,(X),4.1,15034,15034,8853,58.9,8829,58.7,8599,57.2,2679,2679,1845,68.9,5261,5261,3937,74.8
18109,55617,55617,35195,63.3,35084,63.1,33028,59.4,2056,3.7,111,0.2,20422,36.7,35084,35084,(X),5.9,28314,28314,16434,58.0,16434,58.0,15421,54.5,4479,4479,3296,73.6,10450,10450,7403,70.8
18111,11388,11388,6598,57.9,6594,57.9,6161,54.1,433,3.8,4,0.0,4790,42.1,6594,6594,(X),6.6,5676,5676,2690,47.4,2690,47.4,2461,43.4,844,844,402,47.6,2047,2047,1237,60.4
18113,36961,36961,24115,65.2,24059,65.1,22947,62.1,1112,3.0,56,0.2,12846,34.8,24059,24059,(X),4.6,18581,18581,11280,60.7,11280,60.7,10657,57.4,3500,3500,2348,67.1,7772,7772,5663,72.9
18115,4848,4848,3076,63.4,3076,63.4,3004,62.0,72,1.5,0,0.0,1772,36.6,3076,3076,(X),2.3,2451,2451,1400,57.1,1400,57.1,1358,55.4,321,321,230,71.7,733,733,616,84.0
18117,15570,15570,8815,56.6,8815,56.6,8424,54.1,391,2.5,0,0.0,6755,43.4,8815,8815,(X),4.4,7871,7871,4149,52.7,4149,52.7,4033,51.2,1274,1274,811,63.7,3008,3008,2057,68.4
18119,16946,16946,9963,58.8,9963,58.8,9411,55.5,552,3.3,0,0.0,6983,41.2,9963,9963,(X),5.5,8369,8369,4390,52.5,4390,52.5,4118,49.2,1119,1119,634,56.7,2738,2738,1886,68.9
18121,13625,13625,7161,52.6,7146,52.4,6748,49.5,398,2.9,15,0.1,6464,47.4,7146,7146,(X),5.6,7158,7158,2977,41.6,2977,41.6,2838,39.6,1185,1185,666,56.2,2179,2179,1409,64.7
18123,15452,15452,8588,55.6,8588,55.6,8351,54.0,237,1.5,0,0.0,6864,44.4,8588,8588,(X),2.8,7168,7168,4094,57.1,4094,57.1,3999,55.8,1119,1119,826,73.8,2412,2412,1934,80.2
18125,9928,9928,5987,60.3,5978,60.2,5726,57.7,252,2.5,9,0.1,3941,39.7,5978,5978,(X),4.2,4900,4900,2677,54.6,2677,54.6,2628,53.6,654,654,430,65.7,1953,1953,1504,77.0
18127,134986,134986,84151,62.3,84116,62.3,80189,59.4,3927,2.9,35,0.0,50835,37.7,84116,84116,(X),4.7,68757,68757,38318,55.7,38318,55.7,36806,53.5,10709,10709,6907,64.5,25735,25735,18016,70.0
18129,20689,20689,12945,62.6,12945,62.6,12398,59.9,547,2.6,0,0.0,7744,37.4,12945,12945,(X),4.2,10376,10376,6076,58.6,6076,58.6,5854,56.4,1588,1588,1205,75.9,3893,3893,2993,76.9
18131,10112,10112,5874,58.1,5874,58.1,5536,54.7,338,3.3,0,0.0,4238,41.9,5874,5874,(X),5.8,5041,5041,2597,51.5,2597,51.5,2448,48.6,726,726,423,58.3,2072,2072,1414,68.2
18133,31227,31227,16965,54.3,16958,54.3,16250,52.0,708,2.3,7,0.0,14262,45.7,16958,16958,(X),4.2,14863,14863,7909,53.2,7906,53.2,7618,51.3,2015,2015,1378,68.4,4639,4639,3462,74.6
18135,20007,20007,11874,59.3,11869,59.3,11271,56.3,598,3.0,5,0.0,8133,40.7,11869,11869,(X),5.0,10252,10252,5728,55.9,5728,55.9,5480,53.5,1622,1622,1142,70.4,3863,3863,3032,78.5
18137,22634,22634,14717,65.0,14698,64.9,13884,61.3,814,3.6,19,0.1,7917,35.0,14698,14698,(X),5.5,11544,11544,6830,59.2,6830,59.2,6536,56.6,1990,1990,1451,72.9,4239,4239,3217,75.9
18139,13372,13372,7835,58.6,7835,58.6,7440,55.6,395,3.0,0,0.0,5537,41.4,7835,7835,(X),5.0,6796,6796,3542,52.1,3542,52.1,3323,48.9,1040,1040,594,57.1,2514,2514,1630,64.8
18141,212043,212043,135759,64.0,135582,63.9,128360,60.5,7222,3.4,177,0.1,76284,36.0,135582,135582,(X),5.3,110515,110515,66198,59.9,66158,59.9,62637,56.7,19778,19778,13040,65.9,41616,41616,31058,74.6
18143,18974,18974,10608,55.9,10574,55.7,10004,52.7,570,3.0,34,0.2,8366,44.1,10574,10574,(X),5.4,9719,9719,4983,51.3,4983,51.3,4769,49.1,1565,1565,1121,71.6,3547,3547,2234,63.0
18145,35369,35369,23135,65.4,23125,65.4,22158,62.6,967,2.7,10,0.0,12234,34.6,23125,23125,(X),4.2,18011,18011,10768,59.8,10768,59.8,10273,57.0,2736,2736,2122,77.6,6868,6868,5277,76.8
18147,16466,16466,10384,63.1,10370,63.0,9947,60.4,423,2.6,14,0.1,6082,36.9,10370,10370,(X),4.1,8196,8196,4608,56.2,4594,56.1,4397,53.6,1254,1254,887,70.7,3087,3087,2334,75.6
18149,18282,18282,10399,56.9,10393,56.8,9661,52.8,732,4.0,6,0.0,7883,43.1,10393,10393,(X),7.0,9311,9311,4861,52.2,4861,52.2,4565,49.0,1594,1594,925,58.0,3394,3394,2104,62.0
18151,28127,28127,17940,63.8,17930,63.7,17250,61.3,680,2.4,10,0.0,10187,36.2,17930,17930,(X),3.8,13859,13859,7961,57.4,7961,57.4,7657,55.2,2106,2106,1413,67.1,4427,4427,3124,70.6
18153,17119,17119,8833,51.6,8833,51.6,8286,48.4,547,3.2,0,0.0,8286,48.4,8833,8833,(X),6.2,7770,7770,3768,48.5,3768,48.5,3618,46.6,1252,1252,797,63.7,2738,2738,2010,73.4
18155,8280,8280,4619,55.8,4619,55.8,4355,52.6,264,3.2,0,0.0,3661,44.2,4619,4619,(X),5.7,4065,4065,2020,49.7,2020,49.7,1933,47.6,806,806,399,49.5,1781,1781,1090,61.2
18157,154524,154524,99222,64.2,99042,64.1,94285,61.0,4757,3.1,180,0.1,55302,35.8,99042,99042,(X),4.8,75240,75240,45738,60.8,45738,60.8,43158,57.4,12651,12651,8653,68.4,24466,24466,18874,77.1
18159,12584,12584,7710,61.3,7698,61.2,7450,59.2,248,2.0,12,0.1,4874,38.7,7698,7698,(X),3.2,6298,6298,3417,54.3,3405,54.1,3277,52.0,850,850,676,79.5,1915,1915,1428,74.6
18161,5825,5825,3462,59.4,3462,59.4,3368,57.8,94,1.6,0,0.0,2363,40.6,3462,3462,(X),2.7,2985,2985,1670,55.9,1670,55.9,1651,55.3,319,319,208,65.2,961,961,841,87.5
18163,146139,146139,92143,63.1,92143,63.1,87595,59.9,4548,3.1,0,0.0,53996,36.9,92143,92143,(X),4.9,76332,76332,44909,58.8,44909,58.8,42636,55.9,13007,13007,9716,74.7,23866,23866,17556,73.6
18165,12541,12541,6905,55.1,6898,55.0,6549,52.2,349,2.8,7,0.1,5636,44.9,6898,6898,(X),5.1,6371,6371,3110,48.8,3110,48.8,2932,46.0,882,882,477,54.1,2299,2299,1301,56.6
18167,88237,88237,52783,59.8,52723,59.8,48565,55.0,4158,4.7,60,0.1,35454,40.2,52723,52723,(X),7.9,43663,43663,25434,58.3,25434,58.3,23741,54.4,6890,6890,4880,70.8,13504,13504,10736,79.5
18169,25812,25812,15509,60.1,15484,60.0,14813,57.4,671,2.6,25,0.1,10303,39.9,15484,15484,(X),4.3,13309,13309,7199,54.1,7199,54.1,6866,51.6,1860,1860,1394,74.9,4074,4074,2713,66.6
18171,6594,6594,4106,62.3,4106,62.3,3948,59.9,158,2.4,0,0.0,2488,37.7,4106,4106,(X),3.8,3315,3315,1870,56.4,1870,56.4,1818,54.8,472,472,329,69.7,1180,1180,825,69.9
18173,48769,48769,32642,66.9,32642,66.9,31570,64.7,1072,2.2,0,0.0,16127,33.1,32642,32642,(X),3.3,24874,24874,15068,60.6,15068,60.6,14529,58.4,4084,4084,2965,72.6,10194,10194,7627,74.8
18175,22116,22116,12820,58.0,12808,57.9,12021,54.4,787,3.6,12,0.1,9296,42.0,12808,12808,(X),6.1,11086,11086,5528,49.9,5528,49.9,5105,46.0,1822,1822,927,50.9,4288,4288,2767,64.5
18177,53623,53623,31589,58.9,31575,58.9,29728,55.4,1847,3.4,14,0.0,22034,41.1,31575,31575,(X),5.8,27869,27869,15522,55.7,15514,55.7,14618,52.5,4298,4298,3028,70.5,9218,9218,6949,75.4
18179,21765,21765,14138,65.0,14084,64.7,13750,63.2,334,1.5,54,0.2,7627,35.0,14084,14084,(X),2.4,11157,11157,6304,56.5,6304,56.5,6223,55.8,2092,2092,1467,70.1,4701,4701,3544,75.4
18181,19198,19198,12025,62.6,11961,62.3,11453,59.7,508,2.6,64,0.3,7173,37.4,11961,11961,(X),4.2,9564,9564,5436,56.8,5436,56.8,5165,54.0,1770,1770,1322,74.7,3597,3597,2721,75.6
18183,26736,26736,17498,65.4,17484,65.4,16976,63.5,508,1.9,14,0.1,9238,34.6,17484,17484,(X),2.9,13637,13637,8015,58.8,8015,58.8,7712,56.6,2353,2353,1708,72.6,5108,5108,3881,76.0
19001,5725,5725,3708,64.8,3708,64.8,3580,62.5,128,2.2,0,0.0,2017,35.2,3708,3708,(X),3.5,2903,2903,1731,59.6,1731,59.6,1675,57.7,388,388,285,73.5,1021,1021,795,77.9
19003,3020,3020,1807,59.8,1807,59.8,1756,58.1,51,1.7,0,0.0,1213,40.2,1807,1807,(X),2.8,1546,1546,829,53.6,829,53.6,810,52.4,315,315,214,67.9,454,454,347,76.4
19005,11091,11091,7101,64.0,7101,64.0,6923,62.4,178,1.6,0,0.0,3990,36.0,7101,7101,(X),2.5,5451,5451,3113,57.1,3113,57.1,3058,56.1,1044,1044,771,73.9,2055,2055,1519,73.9
19007,10059,10059,5834,58.0,5834,58.0,5520,54.9,314,3.1,0,0.0,4225,42.0,5834,5834,(X),5.4,5204,5204,2708,52.0,2708,52.0,2614,50.2,943,943,559,59.3,1604,1604,1040,64.8
19009,4699,4699,2998,63.8,2982,63.5,2908,61.9,74,1.6,16,0.3,1701,36.2,2982,2982,(X),2.5,2422,2422,1429,59.0,1429,59.0,1409,58.2,307,307,266,86.6,714,714,574,80.4
19011,20326,20326,13716,67.5,13716,67.5,13323,65.5,393,1.9,0,0.0,6610,32.5,13716,13716,(X),2.9,10169,10169,6370,62.6,6370,62.6,6182,60.8,1757,1757,1389,79.1,3971,3971,3192,80.4
19013,107262,107262,72938,68.0,72835,67.9,69573,64.9,3262,3.0,103,0.1,34324,32.0,72835,72835,(X),4.5,55043,55043,35553,64.6,35541,64.6,34090,61.9,9675,9675,7469,77.2,18080,18080,14513,80.3
19015,21482,21482,14452,67.3,14429,67.2,13879,64.6,550,2.6,23,0.1,7030,32.7,14429,14429,(X),3.8,10732,10732,6641,61.9,6641,61.9,6404,59.7,1886,1886,1449,76.8,3505,3505,2957,84.4
19017,20007,20007,13403,67.0,13386,66.9,12957,64.8,429,2.1,17,0.1,6604,33.0,13386,13386,(X),3.2,10249,10249,6415,62.6,6415,62.6,6233,60.8,1736,1736,1361,78.4,3467,3467,2839,81.9
19019,15984,15984,10725,67.1,10725,67.1,10407,65.1,318,2.0,0,0.0,5259,32.9,10725,10725,(X),3.0,8079,8079,5098,63.1,5098,63.1,5003,61.9,1748,1748,1331,76.1,3712,3712,3136,84.5
19021,15640,15640,11113,71.1,11113,71.1,10523,67.3,590,3.8,0,0.0,4527,28.9,11113,11113,(X),5.3,7697,7697,5004,65.0,5004,65.0,4810,62.5,1787,1787,1324,74.1,3138,3138,2448,78.0
19023,11688,11688,7543,64.5,7537,64.5,7287,62.3,250,2.1,6,0.1,4145,35.5,7537,7537,(X),3.3,5917,5917,3539,59.8,3536,59.8,3434,58.0,927,927,698,75.3,2321,2321,1883,81.1
19025,7939,7939,4527,57.0,4514,56.9,4416,55.6,98,1.2,13,0.2,3412,43.0,4514,4514,(X),2.2,3849,3849,2187,56.8,2187,56.8,2121,55.1,729,729,564,77.4,1236,1236,1035,83.7
19027,15870,15870,10879,68.6,10855,68.4,10632,67.0,223,1.4,24,0.2,4991,31.4,10855,10855,(X),2.1,8148,8148,5205,63.9,5205,63.9,5110,62.7,1681,1681,1508,89.7,3144,3144,2800,89.1
19029,10670,10670,6614,62.0,6614,62.0,6455,60.5,159,1.5,0,0.0,4056,38.0,6614,6614,(X),2.4,5436,5436,3050,56.1,3050,56.1,2998,55.2,874,874,612,70.0,1959,1959,1453,74.2
19031,14731,14731,10199,69.2,10199,69.2,9920,67.3,279,1.9,0,0.0,4532,30.8,10199,10199,(X),2.7,7463,7463,4879,65.4,4879,65.4,4794,64.2,1126,1126,940,83.5,2942,2942,2721,92.5
19033,35271,35271,22861,64.8,22840,64.8,21912,62.1,928,2.6,21,0.1,12410,35.2,22840,22840,(X),4.1,18317,18317,10896,59.5,10896,59.5,10443,57.0,2693,2693,2192,81.4,5814,5814,5020,86.3
19035,9298,9298,6073,65.3,6071,65.3,5930,63.8,141,1.5,2,0.0,3225,34.7,6071,6071,(X),2.3,4624,4624,2734,59.1,2734,59.1,2670,57.7,783,783,728,93.0,1346,1346,1250,92.9
19037,9639,9639,6583,68.3,6583,68.3,6457,67.0,126,1.3,0,0.0,3056,31.7,6583,6583,(X),1.9,4785,4785,3007,62.8,3007,62.8,2944,61.5,857,857,687,80.2,1797,1797,1499,83.4
19039,7216,7216,4765,66.0,4765,66.0,4612,63.9,153,2.1,0,0.0,2451,34.0,4765,4765,(X),3.2,3657,3657,2165,59.2,2165,59.2,2081,56.9,697,697,435,62.4,1536,1536,898,58.5
19041,13003,13003,8569,65.9,8569,65.9,8262,63.5,307,2.4,0,0.0,4434,34.1,8569,8569,(X),3.6,6631,6631,3857,58.2,3857,58.2,3787,57.1,1146,1146,841,73.4,2347,2347,2059,87.7
19043,14243,14243,9379,65.8,9379,65.8,9181,64.5,198,1.4,0,0.0,4864,34.2,9379,9379,(X),2.1,7077,7077,4260,60.2,4260,60.2,4184,59.1,1186,1186,785,66.2,2388,2388,1832,76.7
19045,37636,37636,23715,63.0,23705,63.0,22653,60.2,1052,2.8,10,0.0,13921,37.0,23705,23705,(X),4.4,19344,19344,11281,58.3,11279,58.3,10873,56.2,3219,3219,2361,73.3,6689,6689,5247,78.4
19047,13354,13354,8599,64.4,8592,64.3,7993,59.9,599,4.5,7,0.1,4755,35.6,8592,8592,(X),7.0,6554,6554,3740,57.1,3740,57.1,3376,51.5,1324,1324,995,75.2,2752,2752,2182,79.3
19049,62881,62881,47219,75.1,47154,75.0,46027,73.2,1127,1.8,65,0.1,15662,24.9,47154,47154,(X),2.4,32262,32262,22551,69.9,22542,69.9,22080,68.4,8032,8032,5640,70.2,15095,15095,11990,79.4
19051,6553,6553,4279,65.3,4279,65.3,4158,63.5,121,1.8,0,0.0,2274,34.7,4279,4279,(X),2.8,3271,3271,1775,54.3,1775,54.3,1729,52.9,927,927,429,46.3,1601,1601,745,46.5
19053,6480,6480,3892,60.1,3892,60.1,3720,57.4,172,2.7,0,0.0,2588,39.9,3892,3892,(X),4.4,3233,3233,1830,56.6,1830,56.6,1762,54.5,553,553,343,62.0,1140,1140,914,80.2
19055,13640,13640,9558,70.1,9558,70.1,9334,68.4,224,1.6,0,0.0,4082,29.9,9558,9558,(X),2.3,6818,6818,4490,65.9,4490,65.9,4358,63.9,1164,1164,971,83.4,2808,2808,2452,87.3
19057,31589,31589,20165,63.8,20147,63.8,19087,60.4,1060,3.4,18,0.1,11424,36.2,20147,20147,(X),5.3,16386,16386,9633,58.8,9633,58.8,9118,55.6,2517,2517,2074,82.4,5881,5881,4963,84.4
19059,14263,14263,9454,66.3,9454,66.3,9189,64.4,265,1.9,0,0.0,4809,33.7,9454,9454,(X),2.8,7271,7271,4401,60.5,4401,60.5,4294,59.1,956,956,814,85.1,2129,2129,1779,83.6
19061,77130,77130,52592,68.2,52528,68.1,50388,65.3,2140,2.8,64,0.1,24538,31.8,52528,52528,(X),4.1,39307,39307,25200,64.1,25191,64.1,24326,61.9,7307,7307,6127,83.9,14049,14049,12067,85.9
19063,7810,7810,4967,63.6,4967,63.6,4802,61.5,165,2.1,0,0.0,2843,36.4,4967,4967,(X),3.3,3936,3936,2256,57.3,2256,57.3,2209,56.1,574,574,475,82.8,1265,1265,1003,79.3
19065,16235,16235,10290,63.4,10290,63.4,9937,61.2,353,2.2,0,0.0,5945,36.6,10290,10290,(X),3.4,8132,8132,4873,59.9,4873,59.9,4742,58.3,1311,1311,1007,76.8,2675,2675,2009,75.1
19067,12658,12658,8125,64.2,8125,64.2,7920,62.6,205,1.6,0,0.0,4533,35.8,8125,8125,(X),2.5,6455,6455,3779,58.5,3779,58.5,3685,57.1,1144,1144,792,69.2,2408,2408,1797,74.6
19069,8059,8059,5042,62.6,5042,62.6,4845,60.1,197,2.4,0,0.0,3017,37.4,5042,5042,(X),3.9,4095,4095,2295,56.0,2295,56.0,2208,53.9,729,729,514,70.5,1599,1599,1180,73.8
19071,5623,5623,3501,62.3,3501,62.3,3373,60.0,128,2.3,0,0.0,2122,37.7,3501,3501,(X),3.7,2835,2835,1609,56.8,1609,56.8,1541,54.4,427,427,293,68.6,989,989,778,78.7
19073,7198,7198,4749,66.0,4749,66.0,4498,62.5,251,3.5,0,0.0,2449,34.0,4749,4749,(X),5.3,3724,3724,2224,59.7,2224,59.7,2064,55.4,634,634,532,83.9,1355,1355,1155,85.2
19075,9809,9809,6380,65.0,6380,65.0,6244,63.7,136,1.4,0,0.0,3429,35.0,6380,6380,(X),2.1,5008,5008,2930,58.5,2930,58.5,2867,57.2,855,855,653,76.4,1924,1924,1393,72.4
19077,8530,8530,5467,64.1,5459,64.0,5275,61.8,184,2.2,8,0.1,3063,35.9,5459,5459,(X),3.4,4316,4316,2640,61.2,2640,61.2,2572,59.6,606,606,472,77.9,1671,1671,1327,79.4
19079,11965,11965,7851,65.6,7845,65.6,7607,63.6,238,2.0,6,0.1,4114,34.4,7845,7845,(X),3.0,6144,6144,3684,60.0,3684,60.0,3609,58.7,1035,1035,827,79.9,2381,2381,1763,74.0
19081,8790,8790,5767,65.6,5764,65.6,5653,64.3,111,1.3,3,0.0,3023,34.4,5764,5764,(X),1.9,4395,4395,2639,60.0,2639,60.0,2616,59.5,664,664,549,82.7,1648,1648,1435,87.1
19083,14027,14027,8877,63.3,8874,63.3,8713,62.1,161,1.1,3,0.0,5150,36.7,8874,8874,(X),1.8,7042,7042,4164,59.1,4161,59.1,4067,57.8,955,955,677,70.9,2465,2465,1838,74.6
19085,11315,11315,7469,66.0,7461,65.9,7347,64.9,114,1.0,8,0.1,3846,34.0,7461,7461,(X),1.5,5749,5749,3441,59.9,3441,59.9,3384,58.9,997,997,846,84.9,2064,2064,1694,82.1
19087,15997,15997,9852,61.6,9848,61.6,9335,58.4,513,3.2,4,0.0,6145,38.4,9848,9848,(X),5.2,7859,7859,4643,59.1,4643,59.1,4462,56.8,1270,1270,958,75.4,2926,2926,2321,79.3
19089,7189,7189,4906,68.2,4906,68.2,4783,66.5,123,1.7,0,0.0,2283,31.8,4906,4906,(X),2.5,3655,3655,2263,61.9,2263,61.9,2231,61.0,662,662,518,78.2,1567,1567,1348,86.0
19091,7572,7572,4856,64.1,4852,64.1,4672,61.7,180,2.4,4,0.1,2716,35.9,4852,4852,(X),3.7,3885,3885,2230,57.4,2230,57.4,2159,55.6,647,647,501,77.4,1488,1488,1174,78.9
19093,5497,5497,3593,65.4,3593,65.4,3443,62.6,150,2.7,0,0.0,1904,34.6,3593,3593,(X),4.2,2765,2765,1717,62.1,1717,62.1,1593,57.6,495,495,392,79.2,1049,1049,916,87.3
19095,12897,12897,8615,66.8,8589,66.6,8353,64.8,236,1.8,26,0.2,4282,33.2,8589,8589,(X),2.7,6539,6539,4129,63.1,4129,63.1,4027,61.6,1115,1115,817,73.3,2486,2486,2132,85.8
19097,15697,15697,9964,63.5,9964,63.5,9531,60.7,433,2.8,0,0.0,5733,36.5,9964,9964,(X),4.3,7866,7866,4452,56.6,4452,56.6,4316,54.9,1425,1425,1114,78.2,2641,2641,2077,78.6
19099,29537,29537,18498,62.6,18484,62.6,17587,59.5,897,3.0,14,0.0,11039,37.4,18484,18484,(X),4.9,14588,14588,8811,60.4,8811,60.4,8580,58.8,2471,2471,2009,81.3,5286,5286,4264,80.7
19101,15045,15045,8824,58.7,8824,58.7,8235,54.7,589,3.9,0,0.0,6221,41.3,8824,8824,(X),6.7,7436,7436,4327,58.2,4327,58.2,4199,56.5,1334,1334,983,73.7,1844,1844,1651,89.5
19103,120265,120265,85506,71.1,85489,71.1,82627,68.7,2862,2.4,17,0.0,34759,28.9,85489,85489,(X),3.3,60900,60900,41995,69.0,41992,69.0,40660,66.8,10512,10512,7564,72.0,18098,18098,14664,81.0
19105,16646,16646,10218,61.4,10218,61.4,9825,59.0,393,2.4,0,0.0,6428,38.6,10218,10218,(X),3.8,8033,8033,4894,60.9,4894,60.9,4754,59.2,1275,1275,827,64.9,3076,3076,2305,74.9
19107,8158,8158,5255,64.4,5255,64.4,4996,61.2,259,3.2,0,0.0,2903,35.6,5255,5255,(X),4.9,4033,4033,2376,58.9,2376,58.9,2260,56.0,761,761,569,74.8,1462,1462,1220,83.4
19109,12140,12140,7734,63.7,7734,63.7,7496,61.7,238,2.0,0,0.0,4406,36.3,7734,7734,(X),3.1,6138,6138,3515,57.3,3515,57.3,3365,54.8,946,946,826,87.3,2239,2239,1877,83.8
19111,27909,27909,17187,61.6,17158,61.5,15928,57.1,1230,4.4,29,0.1,10722,38.4,17158,17158,(X),7.2,13905,13905,7892,56.8,7892,56.8,7260,52.2,2341,2341,1764,75.4,4771,4771,3776,79.1
19113,175742,175742,122969,70.0,122865,69.9,118580,67.5,4285,2.4,104,0.1,52773,30.0,122865,122865,(X),3.5,90055,90055,59139,65.7,59139,65.7,57013,63.3,16421,16421,12175,74.1,33181,33181,27284,82.2
19115,8959,8959,5808,64.8,5805,64.8,5510,61.5,295,3.3,3,0.0,3151,35.2,5805,5805,(X),5.1,4470,4470,2639,59.0,2639,59.0,2495,55.8,731,731,539,73.7,1781,1781,1297,72.8
19117,6861,6861,4193,61.1,4184,61.0,3981,58.0,203,3.0,9,0.1,2668,38.9,4184,4184,(X),4.9,3458,3458,2049,59.3,2049,59.3,1947,56.3,602,602,422,70.1,1304,1304,981,75.2
19119,8786,8786,6224,70.8,6216,70.7,6089,69.3,127,1.4,8,0.1,2562,29.2,6216,6216,(X),2.0,4354,4354,2785,64.0,2777,63.8,2708,62.2,1078,1078,833,77.3,2216,2216,1835,82.8
19121,12347,12347,8719,70.6,8707,70.5,8363,67.7,344,2.8,12,0.1,3628,29.4,8707,8707,(X),4.0,6239,6239,4108,65.8,4108,65.8,3948,63.3,1056,1056,902,85.4,2881,2881,2357,81.8
19123,17498,17498,11388,65.1,11384,65.1,10783,61.6,601,3.4,4,0.0,6110,34.9,11384,11384,(X),5.3,8731,8731,5146,58.9,5146,58.9,4947,56.7,1697,1697,1238,73.0,3401,3401,2691,79.1
19125,26171,26171,17478,66.8,17478,66.8,16957,64.8,521,2.0,0,0.0,8693,33.2,17478,17478,(X),3.0,13264,13264,8209,61.9,8209,61.9,7912,59.7,2295,2295,1749,76.2,5396,5396,4328,80.2
19127,31188,31188,20104,64.5,20104,64.5,19085,61.2,1019,3.3,0,0.0,11084,35.5,20104,20104,(X),5.1,15599,15599,9135,58.6,9135,58.6,8749,56.1,3076,3076,1897,61.7,6516,6516,5148,79.0
19129,11826,11826,7790,65.9,7767,65.7,7475,63.2,292,2.5,23,0.2,4036,34.1,7767,7767,(X),3.8,5910,5910,3604,61.0,3604,61.0,3465,58.6,960,960,700,72.9,2503,2503,1884,75.3
19131,8431,8431,5392,64.0,5392,64.0,5225,62.0,167,2.0,0,0.0,3039,36.0,5392,5392,(X),3.1,4292,4292,2488,58.0,2488,58.0,2428,56.6,708,708,438,61.9,1725,1725,1267,73.4
19133,7188,7188,4407,61.3,4404,61.3,4269,59.4,135,1.9,3,0.0,2781,38.7,4404,4404,(X),3.1,3735,3735,2122,56.8,2122,56.8,2049,54.9,525,525,410,78.1,1216,1216,973,80.0
19135,6040,6040,3892,64.4,3892,64.4,3662,60.6,230,3.8,0,0.0,2148,35.6,3892,3892,(X),5.9,3001,3001,1761,58.7,1761,58.7,1643,54.7,534,534,360,67.4,1416,1416,1119,79.0
19137,8126,8126,5134,63.2,5125,63.1,4779,58.8,346,4.3,9,0.1,2992,36.8,5125,5125,(X),6.8,4231,4231,2572,60.8,2572,60.8,2332,55.1,689,689,505,73.3,1536,1536,1298,84.5
19139,33407,33407,22056,66.0,22056,66.0,21523,64.4,533,1.6,0,0.0,11351,34.0,22056,22056,(X),2.4,16902,16902,10211,60.4,10211,60.4,10001,59.2,3160,3160,2280,72.2,7041,7041,5532,78.6
19141,11027,11027,7548,68.5,7548,68.5,7379,66.9,169,1.5,0,0.0,3479,31.5,7548,7548,(X),2.2,5536,5536,3362,60.7,3362,60.7,3294,59.5,936,936,662,70.7,2155,2155,1560,72.4
19143,4815,4815,3243,67.4,3243,67.4,3162,65.7,81,1.7,0,0.0,1572,32.6,3243,3243,(X),2.5,2433,2433,1486,61.1,1486,61.1,1453,59.7,414,414,253,61.1,975,975,760,77.9
19145,12729,12729,7484,58.8,7462,58.6,7143,56.1,319,2.5,22,0.2,5245,41.2,7462,7462,(X),4.3,6160,6160,3520,57.1,3520,57.1,3336,54.2,924,924,666,72.1,1867,1867,1509,80.8
19147,7242,7242,4838,66.8,4834,66.7,4781,66.0,53,0.7,4,0.1,2404,33.2,4834,4834,(X),1.1,3664,3664,2209,60.3,2205,60.2,2186,59.7,683,683,566,82.9,1291,1291,1174,90.9
19149,19540,19540,13629,69.7,13621,69.7,13314,68.1,307,1.6,8,0.0,5911,30.3,13621,13621,(X),2.3,10028,10028,6390,63.7,6385,63.7,6228,62.1,1899,1899,1563,82.3,4124,4124,3371,81.7
19151,5584,5584,3513,62.9,3507,62.8,3396,60.8,111,2.0,6,0.1,2071,37.1,3507,3507,(X),3.2,2875,2875,1620,56.3,1620,56.3,1562,54.3,480,480,320,66.7,980,980,711,72.6
19153,367768,367768,265803,72.3,265328,72.1,253971,69.1,11357,3.1,475,0.1,101965,27.7,265328,265328,(X),4.3,188464,188464,127266,67.5,127247,67.5,121842,64.7,39795,39795,29799,74.9,74693,74693,59823,80.1
19155,73899,73899,49378,66.8,49341,66.8,47226,63.9,2115,2.9,37,0.1,24521,33.2,49341,49341,(X),4.3,37997,37997,23786,62.6,23786,62.6,22795,60.0,7176,7176,5593,77.9,13685,13685,11018,80.5
19157,15384,15384,10328,67.1,10328,67.1,9850,64.0,478,3.1,0,0.0,5056,32.9,10328,10328,(X),4.6,7968,7968,5039,63.2,5039,63.2,4843,60.8,1092,1092,923,84.5,2384,2384,2088,87.6
19159,3914,3914,2218,56.7,2218,56.7,2121,54.2,97,2.5,0,0.0,1696,43.3,2218,2218,(X),4.4,2066,2066,1053,51.0,1053,51.0,1009,48.8,387,387,337,87.1,771,771,637,82.6
19161,7908,7908,5182,65.5,5182,65.5,5027,63.6,155,2.0,0,0.0,2726,34.5,5182,5182,(X),3.0,4090,4090,2426,59.3,2426,59.3,2380,58.2,650,650,538,82.8,1477,1477,1134,76.8
19163,135438,135438,88697,65.5,88536,65.4,84812,62.6,3724,2.7,161,0.1,46741,34.5,88536,88536,(X),4.2,69619,69619,42933,61.7,42915,61.6,41046,59.0,13047,13047,9742,74.7,26923,26923,21623,80.3
19165,9419,9419,6204,65.9,6204,65.9,6006,63.8,198,2.1,0,0.0,3215,34.1,6204,6204,(X),3.2,4824,4824,2865,59.4,2865,59.4,2751,57.0,798,798,680,85.2,1829,1829,1392,76.1
19167,26325,26325,19343,73.5,19328,73.4,18820,71.5,508,1.9,15,0.1,6982,26.5,19328,19328,(X),2.6,13150,13150,8743,66.5,8743,66.5,8386,63.8,3045,3045,2102,69.0,6002,6002,4815,80.2
19169,82546,82546,54271,65.7,54205,65.7,51875,62.8,2330,2.8,66,0.1,28275,34.3,54205,54205,(X),4.3,39322,39322,25982,66.1,25949,66.0,24862,63.2,5200,5200,3617,69.6,10211,10211,7951,77.9
19171,13534,13534,8849,65.4,8849,65.4,8512,62.9,337,2.5,0,0.0,4685,34.6,8849,8849,(X),3.8,6824,6824,4159,60.9,4159,60.9,4020,58.9,1156,1156,782,67.6,2559,2559,2057,80.4
19173,4892,4892,3107,63.5,3107,63.5,2993,61.2,114,2.3,0,0.0,1785,36.5,3107,3107,(X),3.7,2464,2464,1403,56.9,1403,56.9,1357,55.1,373,373,293,78.6,987,987,810,82.1
19175,9975,9975,6402,64.2,6402,64.2,6071,60.9,331,3.3,0,0.0,3573,35.8,6402,6402,(X),5.2,5162,5162,3132,60.7,3132,60.7,3043,59.0,829,829,555,66.9,1845,1845,1636,88.7
19177,5681,5681,3293,58.0,3293,58.0,3138,55.2,155,2.7,0,0.0,2388,42.0,3293,3293,(X),4.7,2812,2812,1418,50.4,1418,50.4,1383,49.2,484,484,236,48.8,1192,1192,661,55.5
19179,28163,28163,17527,62.2,17527,62.2,16399,58.2,1128,4.0,0,0.0,10636,37.8,17527,17527,(X),6.4,14378,14378,8478,59.0,8478,59.0,7944,55.3,2604,2604,1924,73.9,4954,4954,3646,73.6
19181,38453,38453,26946,70.1,26886,69.9,25999,67.6,887,2.3,60,0.2,11507,29.9,26886,26886,(X),3.3,19904,19904,13013,65.4,13008,65.4,12645,63.5,3486,3486,2553,73.2,8504,8504,7238,85.1
19183,17296,17296,11607,67.1,11597,67.1,11115,64.3,482,2.8,10,0.1,5689,32.9,11597,11597,(X),4.2,8767,8767,5313,60.6,5313,60.6,5198,59.3,1702,1702,1071,62.9,3613,3613,2684,74.3
19185,5014,5014,2885,57.5,2884,57.5,2817,56.2,67,1.3,1,0.0,2129,42.5,2884,2884,(X),2.3,2545,2545,1244,48.9,1244,48.9,1210,47.5,518,518,271,52.3,1023,1023,691,67.5
19187,29910,29910,17836,59.6,17829,59.6,17033,56.9,796,2.7,7,0.0,12074,40.4,17829,17829,(X),4.5,14433,14433,8232,57.0,8225,57.0,7871,54.5,2553,2553,1915,75.0,4834,4834,3820,79.0
19189,8571,8571,5551,64.8,5551,64.8,5296,61.8,255,3.0,0,0.0,3020,35.2,5551,5551,(X),4.6,4383,4383,2615,59.7,2615,59.7,2467,56.3,746,746,611,81.9,1444,1444,1230,85.2
19191,17124,17124,12036,70.3,12035,70.3,11802,68.9,233,1.4,1,0.0,5088,29.7,12035,12035,(X),1.9,8665,8665,5738,66.2,5738,66.2,5632,65.0,1148,1148,1046,91.1,2503,2503,2274,90.9
19193,78528,78528,54211,69.0,54128,68.9,51572,65.7,2556,3.3,83,0.1,24317,31.0,54128,54128,(X),4.7,40163,40163,25669,63.9,25651,63.9,24451,60.9,8553,8553,6688,78.2,17066,17066,13000,76.2
19195,6094,6094,4046,66.4,4046,66.4,3854,63.2,192,3.2,0,0.0,2048,33.6,4046,4046,(X),4.7,3034,3034,1935,63.8,1935,63.8,1835,60.5,459,459,379,82.6,1056,1056,969,91.8
19197,10054,10054,6057,60.2,6057,60.2,5729,57.0,328,3.3,0,0.0,3997,39.8,6057,6057,(X),5.4,5051,5051,2778,55.0,2778,55.0,2602,51.5,905,905,630,69.6,1935,1935,1499,77.5
20001,10111,10111,6170,61.0,6168,61.0,5887,58.2,281,2.8,2,0.0,3941,39.0,6168,6168,(X),4.6,5147,5147,2829,55.0,2829,55.0,2710,52.7,841,841,583,69.3,1633,1633,1190,72.9
20003,6007,6007,3630,60.4,3630,60.4,3524,58.7,106,1.8,0,0.0,2377,39.6,3630,3630,(X),2.9,3061,3061,1698,55.5,1698,55.5,1636,53.4,582,582,422,72.5,1349,1349,890,66.0
20005,12837,12837,8099,63.1,8097,63.1,7721,60.1,376,2.9,2,0.0,4738,36.9,8097,8097,(X),4.6,6738,6738,4125,61.2,4125,61.2,3949,58.6,1184,1184,746,63.0,2408,2408,1834,76.2
20007,3709,3709,2210,59.6,2210,59.6,2172,58.6,38,1.0,0,0.0,1499,40.4,2210,2210,(X),1.7,1807,1807,984,54.5,984,54.5,982,54.3,370,370,219,59.2,663,663,442,66.7
20009,21049,21049,14043,66.7,14020,66.6,13479,64.0,541,2.6,23,0.1,7006,33.3,14020,14020,(X),3.9,10800,10800,6607,61.2,6607,61.2,6386,59.1,2019,2019,1701,84.2,3820,3820,3317,86.8
20011,11287,11287,6534,57.9,6495,57.5,6334,56.1,161,1.4,39,0.3,4753,42.1,6495,6495,(X),2.5,5755,5755,2986,51.9,2986,51.9,2946,51.2,1146,1146,686,59.9,2457,2457,1601,65.2
20013,7424,7424,4672,62.9,4668,62.9,4500,60.6,168,2.3,4,0.1,2752,37.1,4668,4668,(X),3.6,3803,3803,2209,58.1,2207,58.0,2107,55.4,730,730,552,75.6,1548,1548,1020,65.9
20015,51404,51404,32632,63.5,32476,63.2,31098,60.5,1378,2.7,156,0.3,18772,36.5,32476,32476,(X),4.2,25652,25652,15480,60.3,15480,60.3,14708,57.3,4554,4554,2732,60.0,11939,11939,8282,69.4
20017,2106,2106,1168,55.5,1168,55.5,1116,53.0,52,2.5,0,0.0,938,44.5,1168,1168,(X),4.5,1051,1051,566,53.9,566,53.9,543,51.7,173,173,135,78.0,430,430,359,83.5
20019,2744,2744,1515,55.2,1515,55.2,1403,51.1,112,4.1,0,0.0,1229,44.8,1515,1515,(X),7.4,1345,1345,682,50.7,682,50.7,650,48.3,217,217,164,75.6,449,449,340,75.7
20021,16135,16135,9142,56.7,9126,56.6,8699,53.9,427,2.6,16,0.1,6993,43.3,9126,9126,(X),4.7,8279,8279,4314,52.1,4314,52.1,4147,50.1,1312,1312,780,59.5,3185,3185,2217,69.6
20023,2175,2175,1281,58.9,1281,58.9,1243,57.1,38,1.7,0,0.0,894,41.1,1281,1281,(X),3.0,1115,1115,571,51.2,571,51.2,551,49.4,176,176,132,75.0,371,371,269,72.5
20025,1593,1593,1032,64.8,1032,64.8,1020,64.0,12,0.8,0,0.0,561,35.2,1032,1032,(X),1.2,808,808,489,60.5,489,60.5,489,60.5,168,168,96,57.1,315,315,236,74.9
20027,6418,6418,4229,65.9,4121,64.2,4016,62.6,105,1.6,108,1.7,2189,34.1,4121,4121,(X),2.5,3205,3205,1973,61.6,1964,61.3,1937,60.4,530,530,358,67.5,1322,1322,1053,79.7
20029,7235,7235,4716,65.2,4716,65.2,4496,62.1,220,3.0,0,0.0,2519,34.8,4716,4716,(X),4.7,3673,3673,2156,58.7,2156,58.7,2056,56.0,661,661,442,66.9,1281,1281,963,75.2
20031,6720,6720,4315,64.2,4314,64.2,4126,61.4,188,2.8,1,0.0,2405,35.8,4314,4314,(X),4.4,3329,3329,1935,58.1,1935,58.1,1867,56.1,509,509,391,76.8,1150,1150,908,79.0
20033,1442,1442,981,68.0,981,68.0,958,66.4,23,1.6,0,0.0,461,32.0,981,981,(X),2.3,735,735,437,59.5,437,59.5,419,57.0,104,104,60,57.7,256,256,224,87.5
20035,28034,28034,16367,58.4,16342,58.3,15544,55.4,798,2.8,25,0.1,11667,41.6,16342,16342,(X),4.9,14037,14037,7657,54.5,7652,54.5,7270,51.8,2656,2656,1719,64.7,5310,5310,3945,74.3
20037,31526,31526,19748,62.6,19723,62.6,18831,59.7,892,2.8,25,0.1,11778,37.4,19723,19723,(X),4.5,15888,15888,9395,59.1,9395,59.1,9083,57.2,2781,2781,1904,68.5,5331,5331,4022,75.4
20039,2386,2386,1418,59.4,1418,59.4,1386,58.1,32,1.3,0,0.0,968,40.6,1418,1418,(X),2.3,1213,1213,625,51.5,625,51.5,604,49.8,193,193,182,94.3,325,325,252,77.5
20041,14991,14991,9255,61.7,9143,61.0,8617,57.5,526,3.5,112,0.7,5736,38.3,9143,9143,(X),5.8,7507,7507,4405,58.7,4385,58.4,4210,56.1,1288,1288,751,58.3,2882,2882,2097,72.8
20043,6437,6437,3878,60.2,3858,59.9,3712,57.7,146,2.3,20,0.3,2559,39.8,3858,3858,(X),3.8,3118,3118,1784,57.2,1784,57.2,1701,54.6,522,522,431,82.6,909,909,690,75.9
20045,99472,99472,69505,69.9,69358,69.7,66273,66.6,3085,3.1,147,0.1,29967,30.1,69358,69358,(X),4.4,50284,50284,33981,67.6,33922,67.5,32711,65.1,7502,7502,5428,72.4,14055,14055,11176,79.5
20047,2325,2325,1477,63.5,1477,63.5,1444,62.1,33,1.4,0,0.0,848,36.5,1477,1477,(X),2.2,1148,1148,634,55.2,634,55.2,622,54.2,177,177,98,55.4,454,454,282,62.1
20049,2089,2089,1060,50.7,1060,50.7,993,47.5,67,3.2,0,0.0,1029,49.3,1060,1060,(X),6.3,1056,1056,503,47.6,503,47.6,480,45.5,135,135,85,63.0,342,342,221,64.6
20051,23250,23250,16646,71.6,16642,71.6,16239,69.8,403,1.7,4,0.0,6604,28.4,16642,16642,(X),2.4,11756,11756,8000,68.1,8000,68.1,7791,66.3,2051,2051,1703,83.0,4007,4007,3478,86.8
20053,5269,5269,2789,52.9,2778,52.7,2678,50.8,100,1.9,11,0.2,2480,47.1,2778,2778,(X),3.6,2206,2206,1316,59.7,1316,59.7,1274,57.8,395,395,296,74.9,689,689,556,80.7
20055,26764,26764,19559,73.1,19559,73.1,18631,69.6,928,3.5,0,0.0,7205,26.9,19559,19559,(X),4.7,13146,13146,8575,65.2,8575,65.2,8218,62.5,3811,3811,2467,64.7,6963,6963,5231,75.1
20057,25043,25043,17723,70.8,17691,70.6,16646,66.5,1045,4.2,32,0.1,7320,29.2,17691,17691,(X),5.9,11975,11975,7336,61.3,7336,61.3,6830,57.0,3742,3742,2064,55.2,6150,6150,4588,74.6
20059,20073,20073,13403,66.8,13385,66.7,12787,63.7,598,3.0,18,0.1,6670,33.2,13385,13385,(X),4.5,10286,10286,6163,59.9,6163,59.9,5844,56.8,1844,1844,1421,77.1,3917,3917,2890,73.8
20061,24906,24906,18078,72.6,12626,50.7,11798,47.4,828,3.3,5452,21.9,6828,27.4,12626,12626,(X),6.6,11558,11558,7128,61.7,6572,56.9,6029,52.2,4751,4751,2505,52.7,5718,5718,3573,62.5
20063,2113,2113,1314,62.2,1314,62.2,1290,61.1,24,1.1,0,0.0,799,37.8,1314,1314,(X),1.8,1097,1097,610,55.6,610,55.6,601,54.8,159,159,119,74.8,368,368,290,78.8
20065,2082,2082,1191,57.2,1191,57.2,1149,55.2,42,2.0,0,0.0,891,42.8,1191,1191,(X),3.5,1061,1061,562,53.0,562,53.0,552,52.0,135,135,91,67.4,319,319,179,56.1
20067,5456,5456,3848,70.5,3814,69.9,3611,66.2,203,3.7,34,0.6,1608,29.5,3814,3814,(X),5.3,2609,2609,1512,58.0,1512,58.0,1460,56.0,856,856,550,64.3,1465,1465,1103,75.3
20069,4485,4485,3260,72.7,3260,72.7,3166,70.6,94,2.1,0,0.0,1225,27.3,3260,3260,(X),2.9,2258,2258,1356,60.1,1356,60.1,1327,58.8,524,524,285,54.4,1214,1214,756,62.3
20071,921,921,570,61.9,570,61.9,565,61.3,5,0.5,0,0.0,351,38.1,570,570,(X),0.9,480,480,266,55.4,266,55.4,266,55.4,90,90,68,75.6,200,200,166,83.0
20073,5025,5025,2982,59.3,2959,58.9,2866,57.0,93,1.9,23,0.5,2043,40.7,2959,2959,(X),3.1,2507,2507,1348,53.8,1325,52.9,1283,51.2,357,357,221,61.9,878,878,708,80.6
20075,1896,1896,1218,64.2,1218,64.2,1192,62.9,26,1.4,0,0.0,678,35.8,1218,1218,(X),2.1,917,917,487,53.1,487,53.1,466,50.8,249,249,170,68.3,495,495,263,53.1
20077,4444,4444,2616,58.9,2616,58.9,2536,57.1,80,1.8,0,0.0,1828,41.1,2616,2616,(X),3.1,2236,2236,1212,54.2,1212,54.2,1171,52.4,405,405,256,63.2,896,896,739,82.5
20079,27030,27030,17448,64.6,17444,64.5,16922,62.6,522,1.9,4,0.0,9582,35.4,17444,17444,(X),3.0,13667,13667,7890,57.7,7890,57.7,7610,55.7,2362,2362,1516,64.2,5716,5716,4211,73.7
20081,3001,3001,2005,66.8,1989,66.3,1938,64.6,51,1.7,16,0.5,996,33.2,1989,1989,(X),2.6,1499,1499,846,56.4,830,55.4,812,54.2,322,322,162,50.3,840,840,484,57.6
20083,1502,1502,976,65.0,976,65.0,946,63.0,30,2.0,0,0.0,526,35.0,976,976,(X),3.1,751,751,390,51.9,390,51.9,384,51.1,136,136,69,50.7,241,241,158,65.6
20085,10382,10382,6582,63.4,6580,63.4,6199,59.7,381,3.7,2,0.0,3800,36.6,6580,6580,(X),5.8,5230,5230,3101,59.3,3101,59.3,2972,56.8,950,950,677,71.3,2103,2103,1764,83.9
20087,15112,15112,9839,65.1,9827,65.0,9287,61.5,540,3.6,12,0.1,5273,34.9,9827,9827,(X),5.5,7485,7485,4556,60.9,4556,60.9,4355,58.2,1298,1298,866,66.7,2854,2854,2321,81.3
20089,2440,2440,1261,51.7,1261,51.7,1228,50.3,33,1.4,0,0.0,1179,48.3,1261,1261,(X),2.6,1203,1203,621,51.6,621,51.6,602,50.0,173,173,121,69.9,319,319,249,78.1
20091,456249,456249,327784,71.8,327589,71.8,317390,69.6,10199,2.2,195,0.0,128465,28.2,327589,327589,(X),3.1,235250,235250,154994,65.9,154966,65.9,150130,63.8,45501,45501,31763,69.8,96631,96631,72017,74.5
20093,2879,2879,1755,61.0,1755,61.0,1693,58.8,62,2.2,0,0.0,1124,39.0,1755,1755,(X),3.5,1478,1478,688,46.5,688,46.5,674,45.6,322,322,171,53.1,748,748,313,41.8
20095,6009,6009,3778,62.9,3778,62.9,3579,59.6,199,3.3,0,0.0,2231,37.1,3778,3778,(X),5.3,3029,3029,1685,55.6,1685,55.6,1586,52.4,429,429,277,64.6,1157,1157,924,79.9
20097,2023,2023,1282,63.4,1282,63.4,1249,61.7,33,1.6,0,0.0,741,36.6,1282,1282,(X),2.6,1020,1020,597,58.5,597,58.5,578,56.7,194,194,101,52.1,326,326,226,69.3
20099,15989,15989,9940,62.2,9940,62.2,9545,59.7,395,2.5,0,0.0,6049,37.8,9940,9940,(X),4.0,8221,8221,4846,58.9,4846,58.9,4675,56.9,1485,1485,893,60.1,2955,2955,2126,71.9
20101,1311,1311,906,69.1,906,69.1,885,67.5,21,1.6,0,0.0,405,30.9,906,906,(X),2.3,638,638,402,63.0,402,63.0,398,62.4,133,133,87,65.4,227,227,174,76.7
20103,63093,63093,38778,61.5,36765,58.3,35313,56.0,1452,2.3,2013,3.2,24315,38.5,36765,36765,(X),3.9,29068,29068,17435,60.0,17251,59.3,16592,57.1,6170,6170,3909,63.4,12340,12340,9301,75.4
20105,2474,2474,1538,62.2,1538,62.2,1464,59.2,74,3.0,0,0.0,936,37.8,1538,1538,(X),4.8,1233,1233,701,56.9,701,56.9,658,53.4,143,143,103,72.0,474,474,286,60.3
20107,7731,7731,4405,57.0,4405,57.0,4145,53.6,260,3.4,0,0.0,3326,43.0,4405,4405,(X),5.9,3944,3944,2136,54.2,2136,54.2,1973,50.0,586,586,501,85.5,1568,1568,1337,85.3
20109,2216,2216,1452,65.5,1448,65.3,1422,64.2,26,1.2,4,0.2,764,34.5,1448,1448,(X),1.8,1131,1131,668,59.1,664,58.7,640,56.6,211,211,114,54.0,463,463,334,72.1
20111,26649,26649,18453,69.2,18422,69.1,17377,65.2,1045,3.9,31,0.1,8196,30.8,18422,18422,(X),5.7,13749,13749,8905,64.8,8905,64.8,8389,61.0,2146,2146,1600,74.6,4735,4735,4040,85.3
20113,22916,22916,15320,66.9,15290,66.7,14932,65.2,358,1.6,30,0.1,7596,33.1,15290,15290,(X),2.3,11699,11699,7026,60.1,7026,60.1,6912,59.1,1857,1857,1260,67.9,4478,4478,3515,78.5
20115,9717,9717,5894,60.7,5891,60.6,5632,58.0,259,2.7,3,0.0,3823,39.3,5891,5891,(X),4.4,4941,4941,2815,57.0,2813,56.9,2646,53.6,788,788,594,75.4,1727,1727,1360,78.7
20117,7729,7729,4978,64.4,4967,64.3,4759,61.6,208,2.7,11,0.1,2751,35.6,4967,4967,(X),4.2,3856,3856,2360,61.2,2360,61.2,2287,59.3,679,679,538,79.2,1513,1513,1244,82.2
20119,3281,3281,2145,65.4,2145,65.4,2084,63.5,61,1.9,0,0.0,1136,34.6,2145,2145,(X),2.8,1679,1679,911,54.3,911,54.3,858,51.1,352,352,216,61.4,706,706,485,68.7
20121,25863,25863,17003,65.7,16941,65.5,16404,63.4,537,2.1,62,0.2,8860,34.3,16941,16941,(X),3.2,13122,13122,8080,61.6,8074,61.5,7784,59.3,2229,2229,1331,59.7,5691,5691,4569,80.3
20123,4978,4978,2840,57.1,2840,57.1,2753,55.3,87,1.7,0,0.0,2138,42.9,2840,2840,(X),3.1,2445,2445,1323,54.1,1323,54.1,1303,53.3,514,514,264,51.4,873,873,605,69.3
20125,25940,25940,15371,59.3,15363,59.2,14519,56.0,844,3.3,8,0.0,10569,40.7,15363,15363,(X),5.5,13246,13246,6862,51.8,6862,51.8,6593,49.8,2565,2565,1739,67.8,4924,4924,3575,72.6
20127,4480,4480,2693,60.1,2687,60.0,2602,58.1,85,1.9,6,0.1,1787,39.9,2687,2687,(X),3.2,2250,2250,1198,53.2,1198,53.2,1180,52.4,324,324,254,78.4,829,829,685,82.6
20129,2216,2216,1323,59.7,1323,59.7,1276,57.6,47,2.1,0,0.0,893,40.3,1323,1323,(X),3.6,1150,1150,574,49.9,574,49.9,543,47.2,209,209,111,53.1,492,492,324,65.9
20131,7766,7766,5233,67.4,5233,67.4,5132,66.1,101,1.3,0,0.0,2533,32.6,5233,5233,(X),1.9,3909,3909,2500,64.0,2500,64.0,2453,62.8,835,835,579,69.3,1732,1732,1477,85.3
20133,12534,12534,7646,61.0,7646,61.0,7359,58.7,287,2.3,0,0.0,4888,39.0,7646,7646,(X),3.8,6396,6396,3519,55.0,3519,55.0,3404,53.2,1155,1155,632,54.7,2443,2443,1758,72.0
20135,2371,2371,1426,60.1,1426,60.1,1387,58.5,39,1.6,0,0.0,945,39.9,1426,1426,(X),2.7,1161,1161,590,50.8,590,50.8,573,49.4,214,214,130,60.7,421,421,242,57.5
20137,4526,4526,2469,54.6,2469,54.6,2440,53.9,29,0.6,0,0.0,2057,45.4,2469,2469,(X),1.2,1932,1932,1208,62.5,1208,62.5,1184,61.3,363,363,346,95.3,662,662,580,87.6
20139,12605,12605,7860,62.4,7835,62.2,7419,58.9,416,3.3,25,0.2,4745,37.6,7835,7835,(X),5.3,6360,6360,3755,59.0,3748,58.9,3572,56.2,1184,1184,870,73.5,2319,2319,1821,78.5
20141,2916,2916,1817,62.3,1817,62.3,1771,60.7,46,1.6,0,0.0,1099,37.7,1817,1817,(X),2.5,1468,1468,871,59.3,871,59.3,844,57.5,286,286,184,64.3,435,435,384,88.3
20143,4747,4747,3029,63.8,3029,63.8,2949,62.1,80,1.7,0,0.0,1718,36.2,3029,3029,(X),2.6,2346,2346,1363,58.1,1363,58.1,1331,56.7,351,351,262,74.6,923,923,769,83.3
20145,5728,5728,2653,46.3,2653,46.3,2595,45.3,58,1.0,0,0.0,3075,53.7,2653,2653,(X),2.2,2508,2508,1246,49.7,1246,49.7,1244,49.6,350,350,285,81.4,661,661,521,78.8
20147,4320,4320,2758,63.8,2758,63.8,2690,62.3,68,1.6,0,0.0,1562,36.2,2758,2758,(X),2.5,2199,2199,1312,59.7,1312,59.7,1274,57.9,376,376,276,73.4,824,824,620,75.2
20149,17510,17510,11666,66.6,11323,64.7,10868,62.1,455,2.6,343,2.0,5844,33.4,11323,11323,(X),4.0,8793,8793,5187,59.0,5157,58.6,4888,55.6,2177,2177,1149,52.8,4514,4514,3088,68.4
20151,7402,7402,4802,64.9,4695,63.4,4515,61.0,180,2.4,107,1.4,2600,35.1,4695,4695,(X),3.8,3760,3760,2200,58.5,2200,58.5,2086,55.5,808,808,332,41.1,1326,1326,930,70.1
20153,2052,2052,1245,60.7,1245,60.7,1226,59.7,19,0.9,0,0.0,807,39.3,1245,1245,(X),1.5,1007,1007,498,49.5,498,49.5,489,48.6,154,154,111,72.1,327,327,234,71.6
20155,50388,50388,31304,62.1,31274,62.1,29866,59.3,1408,2.8,30,0.1,19084,37.9,31274,31274,(X),4.5,25093,25093,14796,59.0,14796,59.0,14177,56.5,4206,4206,2784,66.2,9632,9632,7842,81.4
20157,3902,3902,2392,61.3,2391,61.3,2332,59.8,59,1.5,1,0.0,1510,38.7,2391,2391,(X),2.5,2031,2031,1147,56.5,1147,56.5,1118,55.0,315,315,212,67.3,554,554,464,83.8
20159,7797,7797,5017,64.3,5017,64.3,4753,61.0,264,3.4,0,0.0,2780,35.7,5017,5017,(X),5.3,3882,3882,2375,61.2,2375,61.2,2276,58.6,734,734,466,63.5,1377,1377,1048,76.1
20161,63798,63798,45162,70.8,38784,60.8,36646,57.4,2138,3.4,6378,10.0,18636,29.2,38784,38784,(X),5.5,29515,29515,18969,64.3,18703,63.4,17664,59.8,5012,5012,3191,63.7,7092,7092,5323,75.1
20163,4091,4091,2518,61.5,2514,61.5,2414,59.0,100,2.4,4,0.1,1573,38.5,2514,2514,(X),4.0,2075,2075,1243,59.9,1243,59.9,1178,56.8,386,386,371,96.1,747,747,555,74.3
20165,2530,2530,1541,60.9,1541,60.9,1489,58.9,52,2.1,0,0.0,989,39.1,1541,1541,(X),3.4,1281,1281,777,60.7,777,60.7,746,58.2,192,192,168,87.5,463,463,371,80.1
20167,5706,5706,3438,60.3,3436,60.2,3221,56.4,215,3.8,2,0.0,2268,39.7,3436,3436,(X),6.3,2833,2833,1616,57.0,1616,57.0,1586,56.0,441,441,271,61.5,1030,1030,744,72.2
20169,43504,43504,28604,65.8,28425,65.3,27342,62.8,1083,2.5,179,0.4,14900,34.2,28425,28425,(X),3.8,21988,21988,13126,59.7,13107,59.6,12680,57.7,4060,4060,2811,69.2,8395,8395,6772,80.7
20171,3789,3789,2706,71.4,2692,71.0,2589,68.3,103,2.7,14,0.4,1083,28.6,2692,2692,(X),3.8,1887,1887,1227,65.0,1213,64.3,1131,59.9,358,358,278,77.7,962,962,783,81.4
20173,392826,392826,262389,66.8,260607,66.3,246997,62.9,13610,3.5,1782,0.5,130437,33.2,260607,260607,(X),5.2,200411,200411,122945,61.3,122782,61.3,116407,58.1,43836,43836,29731,67.8,84249,84249,62439,74.1
20175,16088,16088,11328,70.4,11328,70.4,10733,66.7,595,3.7,0,0.0,4760,29.6,11328,11328,(X),5.3,7706,7706,4567,59.3,4567,59.3,4325,56.1,2352,2352,1798,76.4,4451,4451,2781,62.5
20177,140395,140395,88688,63.2,88383,63.0,84391,60.1,3992,2.8,305,0.2,51707,36.8,88383,88383,(X),4.5,73283,73283,43706,59.6,43617,59.5,41912,57.2,13480,13480,9618,71.4,27357,27357,22137,80.9
20179,1941,1941,1290,66.5,1290,66.5,1261,65.0,29,1.5,0,0.0,651,33.5,1290,1290,(X),2.2,969,969,577,59.5,577,59.5,567,58.5,171,171,117,68.4,426,426,269,63.1
20181,4690,4690,3044,64.9,3033,64.7,2905,61.9,128,2.7,11,0.2,1646,35.1,3033,3033,(X),4.2,2398,2398,1352,56.4,1352,56.4,1331,55.5,456,456,229,50.2,955,955,760,79.6
20183,3030,3030,1745,57.6,1745,57.6,1697,56.0,48,1.6,0,0.0,1285,42.4,1745,1745,(X),2.8,1527,1527,790,51.7,790,51.7,766,50.2,210,210,131,62.4,490,490,322,65.7
20185,3329,3329,2131,64.0,2131,64.0,2040,61.3,91,2.7,0,0.0,1198,36.0,2131,2131,(X),4.3,1664,1664,950,57.1,950,57.1,931,55.9,254,254,124,48.8,672,672,544,81.0
20187,1582,1582,1046,66.1,1046,66.1,1030,65.1,16,1.0,0,0.0,536,33.9,1046,1046,(X),1.5,780,780,469,60.1,469,60.1,453,58.1,149,149,105,70.5,390,390,229,58.7
20189,4160,4160,2684,64.5,2669,64.2,2549,61.3,120,2.9,15,0.4,1476,35.5,2669,2669,(X),4.5,2016,2016,965,47.9,965,47.9,892,44.2,546,546,254,46.5,1090,1090,679,62.3
20191,18163,18163,11144,61.4,11144,61.4,10727,59.1,417,2.3,0,0.0,7019,38.6,11144,11144,(X),3.7,9211,9211,5024,54.5,5024,54.5,4865,52.8,1629,1629,1092,67.0,3887,3887,2877,74.0
20193,6206,6206,4409,71.0,4409,71.0,4327,69.7,82,1.3,0,0.0,1797,29.0,4409,4409,(X),1.9,3258,3258,2113,64.9,2113,64.9,2071,63.6,641,641,531,82.8,1041,1041,839,80.6
20195,2379,2379,1666,70.0,1661,69.8,1634,68.7,27,1.1,5,0.2,713,30.0,1661,1661,(X),1.6,1173,1173,749,63.9,749,63.9,749,63.9,161,161,146,90.7,346,346,226,65.3
20197,5464,5464,3478,63.7,3477,63.6,3368,61.6,109,2.0,1,0.0,1986,36.3,3477,3477,(X),3.1,2710,2710,1595,58.9,1595,58.9,1545,57.0,525,525,283,53.9,1094,1094,680,62.2
20199,1223,1223,801,65.5,801,65.5,781,63.9,20,1.6,0,0.0,422,34.5,801,801,(X),2.5,612,612,373,60.9,373,60.9,363,59.3,118,118,94,79.7,225,225,171,76.0
20201,4429,4429,2772,62.6,2772,62.6,2692,60.8,80,1.8,0,0.0,1657,37.4,2772,2772,(X),2.9,2181,2181,1237,56.7,1237,56.7,1214,55.7,412,412,321,77.9,781,781,553,70.8
20203,1679,1679,1111,66.2,1111,66.2,1084,64.6,27,1.6,0,0.0,568,33.8,1111,1111,(X),2.4,864,864,476,55.1,476,55.1,472,54.6,173,173,129,74.6,354,354,304,85.9
20205,6955,6955,4263,61.3,4263,61.3,4045,58.2,218,3.1,0,0.0,2692,38.7,4263,4263,(X),5.1,3543,3543,2051,57.9,2051,57.9,1980,55.9,606,606,504,83.2,1206,1206,974,80.8
20207,2557,2557,1531,59.9,1531,59.9,1400,54.8,131,5.1,0,0.0,1026,40.1,1531,1531,(X),8.6,1265,1265,677,53.5,677,53.5,605,47.8,225,225,179,79.6,319,319,246,77.1
20209,122894,122894,80876,65.8,80722,65.7,74707,60.8,6015,4.9,154,0.1,42018,34.2,80722,80722,(X),7.5,62877,62877,37644,59.9,37605,59.8,34812,55.4,15412,15412,9943,64.5,27956,27956,20307,72.6
21001,15923,15923,8549,53.7,8549,53.7,8020,50.4,529,3.3,0,0.0,7374,46.3,8549,8549,(X),6.2,8163,8163,3881,47.5,3881,47.5,3648,44.7,1158,1158,829,71.6,2358,2358,1487,63.1
21003,16327,16327,9126,55.9,9120,55.9,8616,52.8,504,3.1,6,0.0,7201,44.1,9120,9120,(X),5.5,8337,8337,4142,49.7,4142,49.7,3922,47.0,1656,1656,954,57.6,2990,2990,2103,70.3
21005,17474,17474,11242,64.3,11242,64.3,10381,59.4,861,4.9,0,0.0,6232,35.7,11242,11242,(X),7.7,9090,9090,5376,59.1,5376,59.1,5045,55.5,1729,1729,1260,72.9,3124,3124,2346,75.1
21007,6487,6487,3537,54.5,3537,54.5,3341,51.5,196,3.0,0,0.0,2950,45.5,3537,3537,(X),5.5,3280,3280,1646,50.2,1646,50.2,1577,48.1,402,402,233,58.0,1200,1200,823,68.6
21009,34610,34610,20074,58.0,20063,58.0,18622,53.8,1441,4.2,11,0.0,14536,42.0,20063,20063,(X),7.2,17970,17970,9396,52.3,9396,52.3,8633,48.0,2976,2976,1866,62.7,6419,6419,4327,67.4
21011,9482,9482,5117,54.0,5115,53.9,4750,50.1,365,3.8,2,0.0,4365,46.0,5115,5115,(X),7.1,4831,4831,2394,49.6,2394,49.6,2205,45.6,890,890,629,70.7,1893,1893,1079,57.0
21013,22027,22027,8300,37.7,8286,37.6,7543,34.2,743,3.4,14,0.1,13727,62.3,8286,8286,(X),9.0,11411,11411,3886,34.1,3886,34.1,3700,32.4,1839,1839,878,47.7,3262,3262,1577,48.3
21015,98981,98981,69297,70.0,69183,69.9,66174,66.9,3009,3.0,114,0.1,29684,30.0,69183,69183,(X),4.3,50256,50256,32766,65.2,32766,65.2,31462,62.6,10199,10199,7177,70.4,22443,22443,17101,76.2
21017,16059,16059,10044,62.5,10044,62.5,9402,58.5,642,4.0,0,0.0,6015,37.5,10044,10044,(X),6.4,8337,8337,4892,58.7,4892,58.7,4668,56.0,1367,1367,1074,78.6,2876,2876,2153,74.9
21019,38929,38929,20195,51.9,20173,51.8,18353,47.1,1820,4.7,22,0.1,18734,48.1,20173,20173,(X),9.0,19616,19616,9811,50.0,9811,50.0,9071,46.2,3285,3285,2269,69.1,5907,5907,4305,72.9
21021,24668,24668,12973,52.6,12973,52.6,12357,50.1,616,2.5,0,0.0,11695,47.4,12973,12973,(X),4.7,12545,12545,6273,50.0,6273,50.0,6086,48.5,1576,1576,1070,67.9,3656,3656,2729,74.6
21023,6457,6457,3833,59.4,3833,59.4,3622,56.1,211,3.3,0,0.0,2624,40.6,3833,3833,(X),5.5,3235,3235,1726,53.4,1726,53.4,1637,50.6,677,677,492,72.7,1219,1219,838,68.7
21025,10771,10771,4470,41.5,4470,41.5,3950,36.7,520,4.8,0,0.0,6301,58.5,4470,4470,(X),11.6,5405,5405,2082,38.5,2082,38.5,1879,34.8,836,836,402,48.1,1335,1335,631,47.3
21027,15994,15994,8495,53.1,8492,53.1,7785,48.7,707,4.4,3,0.0,7499,46.9,8492,8492,(X),8.3,8056,8056,3697,45.9,3697,45.9,3317,41.2,1263,1263,677,53.6,3140,3140,2137,68.1
21029,63802,63802,41330,64.8,41271,64.7,39278,61.6,1993,3.1,59,0.1,22472,35.2,41271,41271,(X),4.8,32375,32375,19578,60.5,19568,60.4,18710,57.8,4823,4823,3747,77.7,11748,11748,9375,79.8
21031,10212,10212,5404,52.9,5404,52.9,5078,49.7,326,3.2,0,0.0,4808,47.1,5404,5404,(X),6.0,5161,5161,2448,47.4,2448,47.4,2317,44.9,830,830,424,51.1,1751,1751,999,57.1
21033,10217,10217,5646,55.3,5646,55.3,5365,52.5,281,2.8,0,0.0,4571,44.7,5646,5646,(X),5.0,5353,5353,2728,51.0,2728,51.0,2562,47.9,894,894,707,79.1,1813,1813,1477,81.5
21035,32556,32556,18799,57.7,18748,57.6,17816,54.7,932,2.9,51,0.2,13757,42.3,18748,18748,(X),5.0,16893,16893,9102,53.9,9102,53.9,8731,51.7,2252,2252,1420,63.1,4296,4296,3394,79.0
21037,75215,75215,48911,65.0,48901,65.0,46679,62.1,2222,3.0,10,0.0,26304,35.0,48901,48901,(X),4.5,38778,38778,23825,61.4,23825,61.4,22789,58.8,6165,6165,4410,71.5,12423,12423,9614,77.4
21039,3897,3897,1979,50.8,1979,50.8,1862,47.8,117,3.0,0,0.0,1918,49.2,1979,1979,(X),5.9,2040,2040,901,44.2,901,44.2,834,40.9,327,327,135,41.3,588,588,342,58.2
21041,8250,8250,4911,59.5,4888,59.2,4446,53.9,442,5.4,23,0.3,3339,40.5,4888,4888,(X),9.0,4032,4032,2199,54.5,2176,54.0,1968,48.8,850,850,613,72.1,1577,1577,1160,73.6
21043,21923,21923,9522,43.4,9509,43.4,8769,40.0,740,3.4,13,0.1,12401,56.6,9509,9509,(X),7.8,11233,11233,4396,39.1,4396,39.1,4042,36.0,1833,1833,888,48.4,3620,3620,1856,51.3
21045,12620,12620,6069,48.1,6069,48.1,5563,44.1,506,4.0,0,0.0,6551,51.9,6069,6069,(X),8.3,6577,6577,2748,41.8,2748,41.8,2523,38.4,1041,1041,511,49.1,2197,2197,1398,63.6
21047,54190,54190,33578,62.0,25851,47.7,23711,43.8,2140,3.9,7727,14.3,20612,38.0,25851,25851,(X),8.3,25155,25155,12959,51.5,12551,49.9,11401,45.3,7621,7621,3789,49.7,10848,10848,7032,64.8
21049,28770,28770,17316,60.2,17270,60.0,16231,56.4,1039,3.6,46,0.2,11454,39.8,17270,17270,(X),6.0,15018,15018,7887,52.5,7887,52.5,7381,49.1,2097,2097,1628,77.6,4974,4974,3557,71.5
21051,16644,16644,6134,36.9,6134,36.9,5492,33.0,642,3.9,0,0.0,10510,63.1,6134,6134,(X),10.5,7834,7834,2690,34.3,2690,34.3,2520,32.2,1360,1360,617,45.4,2575,2575,939,36.5
21053,8191,8191,3849,47.0,3849,47.0,3573,43.6,276,3.4,0,0.0,4342,53.0,3849,3849,(X),7.2,4140,4140,1852,44.7,1852,44.7,1787,43.2,812,812,453,55.8,1336,1336,758,56.7
21055,7334,7334,3795,51.7,3795,51.7,3643,49.7,152,2.1,0,0.0,3539,48.3,3795,3795,(X),4.0,3650,3650,1647,45.1,1647,45.1,1627,44.6,566,566,377,66.6,1188,1188,705,59.3
21057,5473,5473,2586,47.3,2586,47.3,2440,44.6,146,2.7,0,0.0,2887,52.7,2586,2586,(X),5.6,2821,2821,1335,47.3,1335,47.3,1251,44.3,406,406,323,79.6,874,874,532,60.9
21059,78005,78005,48022,61.6,47976,61.5,45375,58.2,2601,3.3,46,0.1,29983,38.4,47976,47976,(X),5.4,40658,40658,22960,56.5,22960,56.5,21788,53.6,7993,7993,5239,65.5,15310,15310,10464,68.3
21061,10132,10132,5083,50.2,5083,50.2,4642,45.8,441,4.4,0,0.0,5049,49.8,5083,5083,(X),8.7,5051,5051,2393,47.4,2393,47.4,2154,42.6,691,691,423,61.2,1391,1391,918,66.0
21063,6323,6323,1880,29.7,1880,29.7,1792,28.3,88,1.4,0,0.0,4443,70.3,1880,1880,(X),4.7,2641,2641,821,31.1,821,31.1,814,30.8,393,393,153,38.9,775,775,345,44.5
21065,11679,11679,5257,45.0,5257,45.0,4625,39.6,632,5.4,0,0.0,6422,55.0,5257,5257,(X),12.0,5901,5901,2492,42.2,2492,42.2,2180,36.9,645,645,239,37.1,2020,2020,1191,59.0
21067,258326,258326,176061,68.2,175829,68.1,166264,64.4,9565,3.7,232,0.1,82265,31.8,175829,175829,(X),5.4,132629,132629,84965,64.1,84950,64.1,80464,60.7,21656,21656,15350,70.9,40493,40493,31829,78.6
21069,11255,11255,6601,58.6,6601,58.6,6145,54.6,456,4.1,0,0.0,4654,41.4,6601,6601,(X),6.9,5754,5754,2887,50.2,2887,50.2,2730,47.4,1224,1224,531,43.4,2050,2050,1311,64.0
21071,29996,29996,11999,40.0,11989,40.0,10592,35.3,1397,4.7,10,0.0,17997,60.0,11989,11989,(X),11.7,15591,15591,5630,36.1,5630,36.1,5151,33.0,2416,2416,915,37.9,4879,4879,1845,37.8
21073,41074,41074,25844,62.9,25804,62.8,24329,59.2,1475,3.6,40,0.1,15230,37.1,25804,25804,(X),5.7,21447,21447,12790,59.6,12750,59.4,12077,56.3,3140,3140,2278,72.5,6616,6616,5477,82.8
21075,5015,5015,2400,47.9,2381,47.5,2223,44.3,158,3.2,19,0.4,2615,52.1,2381,2381,(X),6.6,2551,2551,1277,50.1,1272,49.9,1166,45.7,443,443,324,73.1,828,828,559,67.5
21077,6840,6840,4054,59.3,4046,59.2,3808,55.7,238,3.5,8,0.1,2786,40.7,4046,4046,(X),5.9,3378,3378,1827,54.1,1827,54.1,1680,49.7,631,631,408,64.7,1287,1287,850,66.0
21079,13826,13826,7947,57.5,7947,57.5,7471,54.0,476,3.4,0,0.0,5879,42.5,7947,7947,(X),6.0,7154,7154,3874,54.2,3874,54.2,3672,51.3,1080,1080,798,73.9,2493,2493,1798,72.1
21081,18707,18707,11095,59.3,11082,59.2,10685,57.1,397,2.1,13,0.1,7612,40.7,11082,11082,(X),3.6,9434,9434,4960,52.6,4956,52.5,4777,50.6,1995,1995,1067,53.5,3940,3940,2282,57.9
21083,29278,29278,16952,57.9,16952,57.9,15639,53.4,1313,4.5,0,0.0,12326,42.1,16952,16952,(X),7.7,15065,15065,8257,54.8,8257,54.8,7676,51.0,2851,2851,2096,73.5,5415,5415,3761,69.5
21085,20682,20682,11047,53.4,11040,53.4,10556,51.0,484,2.3,7,0.0,9635,46.6,11040,11040,(X),4.4,10368,10368,5076,49.0,5076,49.0,4795,46.2,1867,1867,1166,62.5,3737,3737,2525,67.6
21087,8967,8967,4767,53.2,4767,53.2,4562,50.9,205,2.3,0,0.0,4200,46.8,4767,4767,(X),4.3,4509,4509,2306,51.1,2306,51.1,2233,49.5,677,677,476,70.3,1570,1570,1022,65.1
21089,28998,28998,15264,52.6,15264,52.6,14012,48.3,1252,4.3,0,0.0,13734,47.4,15264,15264,(X),8.2,15100,15100,7233,47.9,7233,47.9,6667,44.2,2176,2176,1528,70.2,4700,4700,3344,71.1
21091,6721,6721,3852,57.3,3852,57.3,3628,54.0,224,3.3,0,0.0,2869,42.7,3852,3852,(X),5.8,3350,3350,1655,49.4,1655,49.4,1586,47.3,685,685,412,60.1,1384,1384,913,66.0
21093,84498,84498,54238,64.2,50956,60.3,47969,56.8,2987,3.5,3282,3.9,30260,35.8,50956,50956,(X),5.9,42736,42736,24810,58.1,24390,57.1,22981,53.8,8095,8095,5260,65.0,17263,17263,12350,71.5
21095,21554,21554,8285,38.4,8277,38.4,7489,34.7,788,3.7,8,0.0,13269,61.6,8277,8277,(X),9.5,11208,11208,3947,35.2,3947,35.2,3633,32.4,1766,1766,770,43.6,3645,3645,1593,43.7
21097,14893,14893,8438,56.7,8438,56.7,8008,53.8,430,2.9,0,0.0,6455,43.3,8438,8438,(X),5.1,7703,7703,3809,49.4,3809,49.4,3606,46.8,1113,1113,672,60.4,2798,2798,1898,67.8
21099,14482,14482,7622,52.6,7622,52.6,7096,49.0,526,3.6,0,0.0,6860,47.4,7622,7622,(X),6.9,7397,7397,3460,46.8,3460,46.8,3215,43.5,1353,1353,575,42.5,2866,2866,1447,50.5
21101,36813,36813,21433,58.2,21413,58.2,20402,55.4,1011,2.7,20,0.1,15380,41.8,21413,21413,(X),4.7,19234,19234,10306,53.6,10306,53.6,9857,51.2,3138,3138,2443,77.9,6984,6984,5457,78.1
21103,12560,12560,7451,59.3,7451,59.3,7058,56.2,393,3.1,0,0.0,5109,40.7,7451,7451,(X),5.3,6511,6511,3646,56.0,3646,56.0,3435,52.8,1035,1035,705,68.1,2515,2515,1765,70.2
21105,3796,3796,1712,45.1,1712,45.1,1613,42.5,99,2.6,0,0.0,2084,54.9,1712,1712,(X),5.8,2040,2040,852,41.8,852,41.8,822,40.3,234,234,137,58.5,570,570,376,66.0
21107,36390,36390,19864,54.6,19843,54.5,18721,51.4,1122,3.1,21,0.1,16526,45.4,19843,19843,(X),5.7,18990,18990,9422,49.6,9422,49.6,8890,46.8,3215,3215,2003,62.3,6535,6535,4212,64.5
21109,10734,10734,4769,44.4,4769,44.4,4290,40.0,479,4.5,0,0.0,5965,55.6,4769,4769,(X),10.0,5476,5476,1994,36.4,1994,36.4,1831,33.4,936,936,454,48.5,1894,1894,1034,54.6
21111,613949,613949,404780,65.9,404378,65.9,380718,62.0,23660,3.9,402,0.1,209169,34.1,404378,404378,(X),5.9,321443,321443,196897,61.3,196816,61.2,185487,57.7,55047,55047,40283,73.2,105846,105846,80290,75.9
21113,41025,41025,25679,62.6,25679,62.6,24081,58.7,1598,3.9,0,0.0,15346,37.4,25679,25679,(X),6.2,21356,21356,12081,56.6,12081,56.6,11372,53.2,3739,3739,2628,70.3,8407,8407,6127,72.9
21115,18369,18369,7581,41.3,7581,41.3,6854,37.3,727,4.0,0,0.0,10788,58.7,7581,7581,(X),9.6,9480,9480,3520,37.1,3520,37.1,3137,33.1,1594,1594,859,53.9,3073,3073,1666,54.2
21117,129244,129244,87892,68.0,87789,67.9,83543,64.6,4246,3.3,103,0.1,41352,32.0,87789,87789,(X),4.8,65834,65834,41962,63.7,41962,63.7,40120,60.9,12689,12689,9391,74.0,23943,23943,18519,77.3
21119,12660,12660,5281,41.7,5281,41.7,4626,36.5,655,5.2,0,0.0,7379,58.3,5281,5281,(X),12.4,6405,6405,2489,38.9,2489,38.9,2222,34.7,840,840,329,39.2,1926,1926,669,34.7
21121,24906,24906,10984,44.1,10984,44.1,10191,40.9,793,3.2,0,0.0,13922,55.9,10984,10984,(X),7.2,12917,12917,5056,39.1,5056,39.1,4608,35.7,2146,2146,1077,50.2,4668,4668,2286,49.0
21123,11398,11398,6687,58.7,6674,58.6,6287,55.2,387,3.4,13,0.1,4711,41.3,6674,6674,(X),5.8,5747,5747,3041,52.9,3041,52.9,2852,49.6,908,908,666,73.3,1979,1979,1381,69.8
21125,47877,47877,25345,52.9,25278,52.8,23236,48.5,2042,4.3,67,0.1,22532,47.1,25278,25278,(X),8.1,24783,24783,12167,49.1,12141,49.0,11271,45.5,3706,3706,1682,45.4,8785,8785,4747,54.0
21127,12449,12449,5145,41.3,5145,41.3,4679,37.6,466,3.7,0,0.0,7304,58.7,5145,5145,(X),9.1,6371,6371,2349,36.9,2349,36.9,2216,34.8,1069,1069,289,27.0,2239,2239,1101,49.2
21129,5512,5512,2012,36.5,2012,36.5,1838,33.3,174,3.2,0,0.0,3500,63.5,2012,2012,(X),8.6,2670,2670,1020,38.2,1020,38.2,931,34.9,387,387,264,68.2,810,810,482,59.5
21131,8405,8405,3210,38.2,3210,38.2,2880,34.3,330,3.9,0,0.0,5195,61.8,3210,3210,(X),10.3,4283,4283,1405,32.8,1405,32.8,1331,31.1,494,494,125,25.3,1400,1400,578,41.3
21133,18340,18340,8021,43.7,8021,43.7,6993,38.1,1028,5.6,0,0.0,10319,56.3,8021,8021,(X),12.8,9456,9456,3968,42.0,3968,42.0,3611,38.2,1215,1215,781,64.3,2941,2941,1617,55.0
21135,10922,10922,4932,45.2,4932,45.2,4590,42.0,342,3.1,0,0.0,5990,54.8,4932,4932,(X),6.9,5526,5526,2216,40.1,2216,40.1,2101,38.0,842,842,414,49.2,1860,1860,910,48.9
21137,19331,19331,10467,54.1,10467,54.1,9763,50.5,704,3.6,0,0.0,8864,45.9,10467,10467,(X),6.7,10042,10042,5059,50.4,5059,50.4,4622,46.0,1682,1682,944,56.1,3275,3275,1918,58.6
21139,7546,7546,4178,55.4,4178,55.4,3955,52.4,223,3.0,0,0.0,3368,44.6,4178,4178,(X),5.3,3804,3804,1916,50.4,1916,50.4,1808,47.5,525,525,303,57.7,1287,1287,836,65.0
21141,21147,21147,11406,53.9,11395,53.9,10758,50.9,637,3.0,11,0.1,9741,46.1,11395,11395,(X),5.6,10885,10885,5019,46.1,5019,46.1,4761,43.7,1883,1883,1152,61.2,3806,3806,2569,67.5
21143,7101,7101,2936,41.3,2936,41.3,2857,40.2,79,1.1,0,0.0,4165,58.7,2936,2936,(X),2.7,3164,3164,1214,38.4,1214,38.4,1174,37.1,361,361,289,80.1,744,744,588,79.0
21145,52532,52532,30235,57.6,30146,57.4,28879,55.0,1267,2.4,89,0.2,22297,42.4,30146,30146,(X),4.2,27814,27814,14351,51.6,14316,51.5,13792,49.6,4587,4587,2792,60.9,8729,8729,6272,71.9
21147,14313,14313,5243,36.6,5243,36.6,4407,30.8,836,5.8,0,0.0,9070,63.4,5243,5243,(X),15.9,6448,6448,2220,34.4,2220,34.4,1879,29.1,1185,1185,448,37.8,2015,2015,1028,51.0
21149,7269,7269,4065,55.9,4055,55.8,3771,51.9,284,3.9,10,0.1,3204,44.1,4055,4055,(X),7.0,3740,3740,1745,46.7,1735,46.4,1595,42.6,666,666,422,63.4,1490,1490,930,62.4
21151,72741,72741,45086,62.0,45013,61.9,42056,57.8,2957,4.1,73,0.1,27655,38.0,45013,45013,(X),6.6,37716,37716,21672,57.5,21671,57.5,20176,53.5,6197,6197,3957,63.9,11442,11442,8409,73.5
21153,10133,10133,4144,40.9,4144,40.9,3654,36.1,490,4.8,0,0.0,5989,59.1,4144,4144,(X),11.8,5102,5102,2047,40.1,2047,40.1,1747,34.2,731,731,267,36.5,1835,1835,1014,55.3
21155,15069,15069,8526,56.6,8526,56.6,7751,51.4,775,5.1,0,0.0,6543,43.4,8526,8526,(X),9.1,7525,7525,4021,53.4,4021,53.4,3716,49.4,1304,1304,978,75.0,3158,3158,2068,65.5
21157,25633,25633,13705,53.5,13704,53.5,12950,50.5,754,2.9,1,0.0,11928,46.5,13704,13704,(X),5.5,13188,13188,6612,50.1,6612,50.1,6303,47.8,1919,1919,1346,70.1,4031,4031,2843,70.5
21159,9758,9758,3591,36.8,3591,36.8,3099,31.8,492,5.0,0,0.0,6167,63.2,3591,3591,(X),13.7,4254,4254,1522,35.8,1522,35.8,1367,32.1,667,667,396,59.4,1429,1429,887,62.1
21161,13636,13636,7488,54.9,7472,54.8,7067,51.8,405,3.0,16,0.1,6148,45.1,7472,7472,(X),5.4,7005,7005,3461,49.4,3461,49.4,3283,46.9,1071,1071,637,59.5,2445,2445,1602,65.5
21163,22496,22496,13791,61.3,13037,58.0,12105,53.8,932,4.1,754,3.4,8705,38.7,13037,13037,(X),7.1,11165,11165,6047,54.2,5917,53.0,5435,48.7,1845,1845,1157,62.7,4260,4260,2594,60.9
21165,5214,5214,2446,46.9,2446,46.9,2293,44.0,153,2.9,0,0.0,2768,53.1,2446,2446,(X),6.3,2482,2482,1074,43.3,1074,43.3,994,40.0,420,420,190,45.2,717,717,387,54.0
21167,17277,17277,10457,60.5,10436,60.4,9480,54.9,956,5.5,21,0.1,6820,39.5,10436,10436,(X),9.2,8942,8942,4843,54.2,4843,54.2,4313,48.2,1386,1386,1034,74.6,3154,3154,2392,75.8
21169,7972,7972,4152,52.1,4144,52.0,3920,49.2,224,2.8,8,0.1,3820,47.9,4144,4144,(X),5.4,4161,4161,1961,47.1,1961,47.1,1785,42.9,652,652,473,72.5,1492,1492,856,57.4
21171,8546,8546,4689,54.9,4689,54.9,4397,51.5,292,3.4,0,0.0,3857,45.1,4689,4689,(X),6.2,4302,4302,1918,44.6,1918,44.6,1818,42.3,687,687,433,63.0,1505,1505,912,60.6
21173,21861,21861,12143,55.5,12143,55.5,11353,51.9,790,3.6,0,0.0,9718,44.5,12143,12143,(X),6.5,11411,11411,5745,50.3,5745,50.3,5313,46.6,1952,1952,1371,70.2,4050,4050,2911,71.9
21175,11147,11147,3902,35.0,3902,35.0,3671,32.9,231,2.1,0,0.0,7245,65.0,3902,3902,(X),5.9,4853,4853,1894,39.0,1894,39.0,1824,37.6,711,711,258,36.3,1510,1510,642,42.5
21177,25564,25564,12921,50.5,12921,50.5,11770,46.0,1151,4.5,0,0.0,12643,49.5,12921,12921,(X),8.9,12957,12957,5942,45.9,5942,45.9,5512,42.5,1878,1878,907,48.3,4022,4022,3073,76.4
21179,35586,35586,23132,65.0,23132,65.0,21821,61.3,1311,3.7,0,0.0,12454,35.0,23132,23132,(X),5.7,18298,18298,10949,59.8,10949,59.8,10304,56.3,3185,3185,2418,75.9,7280,7280,5443,74.8
21181,5613,5613,3020,53.8,3020,53.8,2805,50.0,215,3.8,0,0.0,2593,46.2,3020,3020,(X),7.1,2971,2971,1394,46.9,1394,46.9,1297,43.7,501,501,317,63.3,928,928,550,59.3
21183,18794,18794,10637,56.6,10594,56.4,9628,51.2,966,5.1,43,0.2,8157,43.4,10594,10594,(X),9.1,9366,9366,4808,51.3,4808,51.3,4366,46.6,1408,1408,944,67.0,3784,3784,2283,60.3
21185,50706,50706,32691,64.5,32574,64.2,31579,62.3,995,2.0,117,0.2,18015,35.5,32574,32574,(X),3.1,23740,23740,14818,62.4,14818,62.4,14322,60.3,3949,3949,2712,68.7,12348,12348,8926,72.3
21187,8494,8494,4320,50.9,4320,50.9,4098,48.2,222,2.6,0,0.0,4174,49.1,4320,4320,(X),5.1,4400,4400,2088,47.5,2088,47.5,2006,45.6,664,664,505,76.1,1742,1742,1206,69.2
21189,3726,3726,1395,37.4,1395,37.4,1245,33.4,150,4.0,0,0.0,2331,62.6,1395,1395,(X),10.8,2096,2096,620,29.6,620,29.6,558,26.6,302,302,215,71.2,506,506,291,57.5
21191,11593,11593,6633,57.2,6633,57.2,6375,55.0,258,2.2,0,0.0,4960,42.8,6633,6633,(X),3.9,5814,5814,3040,52.3,3040,52.3,2920,50.2,845,845,672,79.5,2170,2170,1611,74.2
21193,21621,21621,10304,47.7,10304,47.7,8870,41.0,1434,6.6,0,0.0,11317,52.3,10304,10304,(X),13.9,11086,11086,5167,46.6,5167,46.6,4456,40.2,1783,1783,993,55.7,3416,3416,1883,55.1
21195,49356,49356,22504,45.6,22504,45.6,20501,41.5,2003,4.1,0,0.0,26852,54.4,22504,22504,(X),8.9,25510,25510,10342,40.5,10342,40.5,9633,37.8,3676,3676,1617,44.0,7540,7540,4221,56.0
21197,9677,9677,4995,51.6,4995,51.6,4644,48.0,351,3.6,0,0.0,4682,48.4,4995,4995,(X),7.0,4920,4920,2405,48.9,2405,48.9,2210,44.9,711,711,473,66.5,1805,1805,979,54.2
21199,51522,51522,27508,53.4,27508,53.4,25191,48.9,2317,4.5,0,0.0,24014,46.6,27508,27508,(X),8.4,26555,26555,13508,50.9,13508,50.9,12478,47.0,4156,4156,2712,65.3,8734,8734,6301,72.1
21201,1807,1807,959,53.1,959,53.1,916,50.7,43,2.4,0,0.0,848,46.9,959,959,(X),4.5,829,829,409,49.3,409,49.3,395,47.6,110,110,58,52.7,257,257,162,63.0
21203,13618,13618,7062,51.9,7062,51.9,6477,47.6,585,4.3,0,0.0,6556,48.1,7062,7062,(X),8.3,6995,6995,3380,48.3,3380,48.3,3068,43.9,991,991,737,74.4,2317,2317,1858,80.2
21205,20282,20282,10567,52.1,10567,52.1,10065,49.6,502,2.5,0,0.0,9715,47.9,10567,10567,(X),4.8,10647,10647,5328,50.0,5328,50.0,5075,47.7,1385,1385,888,64.1,2372,2372,1706,71.9
21207,14198,14198,6872,48.4,6872,48.4,6298,44.4,574,4.0,0,0.0,7326,51.6,6872,6872,(X),8.4,7305,7305,3385,46.3,3385,46.3,3282,44.9,1317,1317,810,61.5,2154,2154,1445,67.1
21209,41378,41378,28742,69.5,28677,69.3,27517,66.5,1160,2.8,65,0.2,12636,30.5,28677,28677,(X),4.0,20965,20965,13475,64.3,13469,64.2,12826,61.2,4157,4157,3004,72.3,8778,8778,6773,77.2
21211,36884,36884,23943,64.9,23861,64.7,22729,61.6,1132,3.1,82,0.2,12941,35.1,23861,23861,(X),4.7,19430,19430,11499,59.2,11499,59.2,10903,56.1,3800,3800,2882,75.8,6659,6659,4699,70.6
21213,14112,14112,8515,60.3,8515,60.3,8242,58.4,273,1.9,0,0.0,5597,39.7,8515,8515,(X),3.2,7316,7316,3899,53.3,3899,53.3,3754,51.3,1422,1422,912,64.1,2637,2637,1666,63.2
21215,14715,14715,10175,69.1,10175,69.1,9673,65.7,502,3.4,0,0.0,4540,30.9,10175,10175,(X),4.9,7203,7203,4642,64.4,4642,64.4,4410,61.2,1105,1105,922,83.4,2779,2779,2013,72.4
21217,20297,20297,10872,53.6,10854,53.5,10231,50.4,623,3.1,18,0.1,9425,46.4,10854,10854,(X),5.7,10512,10512,5323,50.6,5323,50.6,4900,46.6,2126,2126,1436,67.5,3370,3370,2165,64.2
21219,9396,9396,5114,54.4,5074,54.0,4716,50.2,358,3.8,40,0.4,4282,45.6,5074,5074,(X),7.1,4761,4761,2412,50.7,2412,50.7,2213,46.5,1153,1153,531,46.1,2076,2076,1122,54.0
21221,11622,11622,6437,55.4,6373,54.8,5750,49.5,623,5.4,64,0.6,5185,44.6,6373,6373,(X),9.8,6030,6030,3100,51.4,3100,51.4,2754,45.7,865,865,503,58.2,1941,1941,1416,73.0
21223,6997,6997,4246,60.7,4246,60.7,3809,54.4,437,6.2,0,0.0,2751,39.3,4246,4246,(X),10.3,3588,3588,1987,55.4,1987,55.4,1797,50.1,456,456,293,64.3,1136,1136,858,75.5
21225,12189,12189,6794,55.7,6785,55.7,6230,51.1,555,4.6,9,0.1,5395,44.3,6785,6785,(X),8.2,5906,5906,2861,48.4,2861,48.4,2632,44.6,905,905,703,77.7,1672,1672,1092,65.3
21227,100801,100801,65571,65.0,65441,64.9,62113,61.6,3328,3.3,130,0.1,35230,35.0,65441,65441,(X),5.1,51795,51795,31088,60.0,31088,60.0,29581,57.1,9004,9004,5822,64.7,17721,17721,12514,70.6
21229,9468,9468,6047,63.9,6047,63.9,5751,60.7,296,3.1,0,0.0,3421,36.1,6047,6047,(X),4.9,4840,4840,2847,58.8,2847,58.8,2757,57.0,773,773,613,79.3,1968,1968,1523,77.4
21231,16790,16790,7703,45.9,7703,45.9,7224,43.0,479,2.9,0,0.0,9087,54.1,7703,7703,(X),6.2,8571,8571,3592,41.9,3592,41.9,3421,39.9,1101,1101,500,45.4,2571,2571,1620,63.0
21233,10469,10469,5408,51.7,5408,51.7,5143,49.1,265,2.5,0,0.0,5061,48.3,5408,5408,(X),4.9,5357,5357,2477,46.2,2477,46.2,2335,43.6,839,839,495,59.0,1917,1917,1161,60.6
21235,28125,28125,13886,49.4,13786,49.0,12639,44.9,1147,4.1,100,0.4,14239,50.6,13786,13786,(X),8.3,14476,14476,6613,45.7,6613,45.7,6259,43.2,2740,2740,1337,48.8,5317,5317,3509,66.0
21237,5719,5719,2182,38.2,2170,37.9,1788,31.3,382,6.7,12,0.2,3537,61.8,2170,2170,(X),17.6,2951,2951,1142,38.7,1142,38.7,939,31.8,483,483,124,25.7,890,890,406,45.6
21239,20868,20868,13516,64.8,13483,64.6,13046,62.5,437,2.1,33,0.2,7352,35.2,13483,13483,(X),3.2,10876,10876,6200,57.0,6189,56.9,5978,55.0,1707,1707,1174,68.8,3990,3990,2961,74.2
22001,47840,47840,27905,58.3,27905,58.3,25356,53.0,2549,5.3,0,0.0,19935,41.7,27905,27905,(X),9.1,24928,24928,12821,51.4,12821,51.4,11547,46.3,5221,5221,3090,59.2,10385,10385,6697,64.5
22003,20448,20448,9531,46.6,9529,46.6,8618,42.1,911,4.5,2,0.0,10917,53.4,9529,9529,(X),9.6,8522,8522,4143,48.6,4143,48.6,3800,44.6,1815,1815,1190,65.6,3395,3395,2398,70.6
22005,92046,92046,62598,68.0,62573,68.0,58813,63.9,3760,4.1,25,0.0,29448,32.0,62573,62573,(X),6.0,47109,47109,29394,62.4,29369,62.3,27490,58.4,10128,10128,7686,75.9,21597,21597,16743,77.5
22007,18223,18223,10050,55.2,10038,55.1,9306,51.1,732,4.0,12,0.1,8173,44.8,10038,10038,(X),7.3,9412,9412,4878,51.8,4866,51.7,4416,46.9,1381,1381,909,65.8,3362,3362,2393,71.2
22009,32229,32229,16193,50.2,16176,50.2,15018,46.6,1158,3.6,17,0.1,16036,49.8,16176,16176,(X),7.2,16142,16142,8385,51.9,8385,51.9,7882,48.8,3032,3032,2031,67.0,6121,6121,4278,69.9
22011,28809,28809,15803,54.9,15479,53.7,14252,49.5,1227,4.3,324,1.1,13006,45.1,15479,15479,(X),7.9,14161,14161,6433,45.4,6389,45.1,6043,42.7,2820,2820,1081,38.3,5624,5624,3886,69.1
22013,10860,10860,4987,45.9,4979,45.8,4710,43.4,269,2.5,8,0.1,5873,54.1,4979,4979,(X),5.4,5758,5758,2452,42.6,2449,42.5,2313,40.2,973,973,491,50.5,1646,1646,1124,68.3
22015,98052,98052,62492,63.7,57861,59.0,54532,55.6,3329,3.4,4631,4.7,35560,36.3,57861,57861,(X),5.8,50017,50017,29025,58.0,28420,56.8,26685,53.4,10347,10347,6470,62.5,19728,19728,14524,73.6
22017,194988,194988,113711,58.3,113171,58.0,105145,53.9,8026,4.1,540,0.3,81277,41.7,113171,113171,(X),7.1,104104,104104,57161,54.9,57108,54.9,53293,51.2,19597,19597,13441,68.6,35742,35742,25379,71.0
22019,155437,155437,95672,61.6,95570,61.5,90129,58.0,5441,3.5,102,0.1,59765,38.4,95570,95570,(X),5.7,80261,80261,45244,56.4,45244,56.4,42752,53.3,16219,16219,10496,64.7,30822,30822,21197,68.8
22021,7863,7863,3686,46.9,3686,46.9,3385,43.0,301,3.8,0,0.0,4177,53.1,3686,3686,(X),8.2,3769,3769,1615,42.8,1615,42.8,1531,40.6,591,591,320,54.1,1405,1405,825,58.7
22023,5631,5631,3390,60.2,3371,59.9,3228,57.3,143,2.5,19,0.3,2241,39.8,3371,3371,(X),4.2,2859,2859,1593,55.7,1593,55.7,1491,52.2,412,412,244,59.2,1002,1002,705,70.4
22025,7942,7942,3735,47.0,3735,47.0,3522,44.3,213,2.7,0,0.0,4207,53.0,3735,3735,(X),5.7,3696,3696,1715,46.4,1715,46.4,1654,44.8,667,667,401,60.1,1371,1371,902,65.8
22027,13563,13563,5804,42.8,5801,42.8,5253,38.7,548,4.0,3,0.0,7759,57.2,5801,5801,(X),9.4,5667,5667,2372,41.9,2372,41.9,2228,39.3,851,851,534,62.7,1647,1647,1109,67.3
22029,15758,15758,7409,47.0,7409,47.0,6939,44.0,470,3.0,0,0.0,8349,53.0,7409,7409,(X),6.3,7753,7753,3980,51.3,3980,51.3,3739,48.2,1468,1468,970,66.1,2788,2788,1920,68.9
22031,21290,21290,11910,55.9,11907,55.9,10683,50.2,1224,5.7,3,0.0,9380,44.1,11907,11907,(X),10.3,11236,11236,6050,53.8,6050,53.8,5454,48.5,1914,1914,1211,63.3,4283,4283,3107,72.5
22033,354458,354458,232263,65.5,231930,65.4,216944,61.2,14986,4.2,333,0.1,122195,34.5,231930,231930,(X),6.5,187143,187143,115265,61.6,115236,61.6,108037,57.7,33072,33072,24313,73.5,62244,62244,46717,75.1
22035,5941,5941,1507,25.4,1507,25.4,1389,23.4,118,2.0,0,0.0,4434,74.6,1507,1507,(X),7.8,2363,2363,903,38.2,903,38.2,811,34.3,414,414,156,37.7,759,759,453,59.7
22037,16321,16321,6997,42.9,6997,42.9,6589,40.4,408,2.5,0,0.0,9324,57.1,6997,6997,(X),5.8,7275,7275,3700,50.9,3700,50.9,3485,47.9,1080,1080,686,63.5,2272,2272,1351,59.5
22039,25926,25926,13444,51.9,13428,51.8,11610,44.8,1818,7.0,16,0.1,12482,48.1,13428,13428,(X),13.5,12606,12606,6382,50.6,6382,50.6,5706,45.3,2716,2716,2080,76.6,5499,5499,3080,56.0
22041,15564,15564,7854,50.5,7854,50.5,7087,45.5,767,4.9,0,0.0,7710,49.5,7854,7854,(X),9.8,8071,8071,3822,47.4,3822,47.4,3588,44.5,1728,1728,1007,58.3,3176,3176,2142,67.4
22043,18206,18206,7758,42.6,7756,42.6,7320,40.2,436,2.4,2,0.0,10448,57.4,7756,7756,(X),5.6,7656,7656,3576,46.7,3576,46.7,3440,44.9,1342,1342,704,52.5,2827,2827,1949,68.9
22045,55738,55738,34028,61.0,34022,61.0,30536,54.8,3486,6.3,6,0.0,21710,39.0,34022,34022,(X),10.2,28553,28553,16231,56.8,16231,56.8,14678,51.4,6157,6157,4432,72.0,11593,11593,8358,72.1
22047,26774,26774,13768,51.4,13689,51.1,12798,47.8,891,3.3,79,0.3,13006,48.6,13689,13689,(X),6.5,13336,13336,6877,51.6,6865,51.5,6598,49.5,2107,2107,1818,86.3,4342,4342,3403,78.4
22049,12727,12727,5822,45.7,5822,45.7,5470,43.0,352,2.8,0,0.0,6905,54.3,5822,5822,(X),6.0,6325,6325,2871,45.4,2871,45.4,2696,42.6,1023,1023,646,63.1,2132,2132,1313,61.6
22051,349859,349859,223303,63.8,222629,63.6,209898,60.0,12731,3.6,674,0.2,126556,36.2,222629,222629,(X),5.7,182251,182251,106474,58.4,106320,58.3,100663,55.2,32176,32176,22417,69.7,59010,59010,44663,75.7
22053,24344,24344,13433,55.2,13426,55.2,12222,50.2,1204,4.9,7,0.0,10911,44.8,13426,13426,(X),9.0,12418,12418,6379,51.4,6379,51.4,5938,47.8,2525,2525,1788,70.8,5141,5141,3743,72.8
22055,189300,189300,125626,66.4,125541,66.3,119459,63.1,6082,3.2,85,0.0,63674,33.6,125541,125541,(X),4.8,97770,97770,59734,61.1,59728,61.1,57012,58.3,19168,19168,13446,70.1,35676,35676,26535,74.4
22057,77288,77288,46551,60.2,46489,60.2,43293,56.0,3196,4.1,62,0.1,30737,39.8,46489,46489,(X),6.9,39555,39555,20782,52.5,20782,52.5,19288,48.8,7221,7221,4471,61.9,14257,14257,9494,66.6
22059,11870,11870,5141,43.3,5137,43.3,4941,41.6,196,1.7,4,0.0,6729,56.7,5137,5137,(X),3.8,5598,5598,2342,41.8,2342,41.8,2256,40.3,1039,1039,589,56.7,2190,2190,1539,70.3
22061,39044,39044,22517,57.7,22480,57.6,20890,53.5,1590,4.1,37,0.1,16527,42.3,22480,22480,(X),7.1,20178,20178,11000,54.5,11000,54.5,10314,51.1,3147,3147,2115,67.2,5598,5598,4101,73.3
22063,106265,106265,66417,62.5,66292,62.4,63181,59.5,3111,2.9,125,0.1,39848,37.5,66292,66292,(X),4.7,54603,54603,30659,56.1,30659,56.1,29400,53.8,10860,10860,7749,71.4,23111,23111,16702,72.3
22065,9015,9015,4069,45.1,4069,45.1,3670,40.7,399,4.4,0,0.0,4946,54.9,4069,4069,(X),9.8,4525,4525,2128,47.0,2128,47.0,1916,42.3,835,835,508,60.8,1428,1428,1136,79.6
22067,20460,20460,9822,48.0,9813,48.0,9279,45.4,534,2.6,9,0.0,10638,52.0,9813,9813,(X),5.4,10786,10786,4742,44.0,4742,44.0,4589,42.5,2101,2101,1447,68.9,3460,3460,2398,69.3
22069,30501,30501,14228,46.6,14227,46.6,12249,40.2,1978,6.5,1,0.0,16273,53.4,14227,14227,(X),13.9,16385,16385,6985,42.6,6984,42.6,5959,36.4,2939,2939,1802,61.3,5776,5776,3656,63.3
22071,318877,318877,195488,61.3,194755,61.1,178375,55.9,16380,5.1,733,0.2,123389,38.7,194755,194755,(X),8.4,169278,169278,100746,59.5,100605,59.4,92422,54.6,26440,26440,18138,68.6,47679,47679,35508,74.5
22073,121249,121249,68924,56.8,68875,56.8,64233,53.0,4642,3.8,49,0.0,52325,43.2,68875,68875,(X),6.7,64203,64203,35698,55.6,35695,55.6,33381,52.0,12769,12769,8823,69.1,24349,24349,18810,77.3
22075,17885,17885,11266,63.0,10415,58.2,10036,56.1,379,2.1,851,4.8,6619,37.0,10415,10415,(X),3.6,9033,9033,4940,54.7,4857,53.8,4612,51.1,1965,1965,1507,76.7,3869,3869,3168,81.9
22077,17717,17717,10072,56.8,10072,56.8,9243,52.2,829,4.7,0,0.0,7645,43.2,10072,10072,(X),8.2,9299,9299,4734,50.9,4734,50.9,4405,47.4,1552,1552,1128,72.7,2890,2890,2170,75.1
22079,102574,102574,58256,56.8,57597,56.2,53433,52.1,4164,4.1,659,0.6,44318,43.2,57597,57597,(X),7.2,53842,53842,28540,53.0,28346,52.6,26829,49.8,10408,10408,7596,73.0,19866,19866,14181,71.4
22081,6744,6744,3310,49.1,3310,49.1,3153,46.8,157,2.3,0,0.0,3434,50.9,3310,3310,(X),4.7,3533,3533,1488,42.1,1488,42.1,1425,40.3,653,653,336,51.5,1119,1119,787,70.3
22083,16211,16211,8198,50.6,8192,50.5,7803,48.1,389,2.4,6,0.0,8013,49.4,8192,8192,(X),4.7,8481,8481,4029,47.5,4029,47.5,3831,45.2,1438,1438,919,63.9,3220,3220,2010,62.4
22085,18970,18970,9039,47.6,9031,47.6,8103,42.7,928,4.9,8,0.0,9931,52.4,9031,9031,(X),10.3,9744,9744,3683,37.8,3683,37.8,3313,34.0,1664,1664,819,49.2,3644,3644,2165,59.4
22087,34568,34568,21002,60.8,21002,60.8,18846,54.5,2156,6.2,0,0.0,13566,39.2,21002,21002,(X),10.3,17858,17858,9850,55.2,9850,55.2,8869,49.7,3840,3840,2552,66.5,7826,7826,5430,69.4
22089,41201,41201,26018,63.1,25919,62.9,24444,59.3,1475,3.6,99,0.2,15183,36.9,25919,25919,(X),5.7,21340,21340,12567,58.9,12555,58.8,11867,55.6,3918,3918,2776,70.9,8608,8608,6650,77.3
22091,8333,8333,4217,50.6,4217,50.6,3645,43.7,572,6.9,0,0.0,4116,49.4,4217,4217,(X),13.6,4317,4317,2076,48.1,2076,48.1,1878,43.5,669,669,452,67.6,1401,1401,1200,85.7
22093,17030,17030,9634,56.6,9634,56.6,9012,52.9,622,3.7,0,0.0,7396,43.4,9634,9634,(X),6.5,8977,8977,4666,52.0,4666,52.0,4253,47.4,1577,1577,1276,80.9,3019,3019,2230,73.9
22095,34029,34029,20964,61.6,20915,61.5,19419,57.1,1496,4.4,49,0.1,13065,38.4,20915,20915,(X),7.2,17477,17477,10103,57.8,10103,57.8,9363,53.6,3327,3327,2315,69.6,7042,7042,5573,79.1
22097,63179,63179,32377,51.2,32343,51.2,30347,48.0,1996,3.2,34,0.1,30802,48.8,32343,32343,(X),6.2,33403,33403,15872,47.5,15862,47.5,15061,45.1,6990,6990,4149,59.4,14201,14201,9612,67.7
22099,42030,42030,25099,59.7,25092,59.7,23380,55.6,1712,4.1,7,0.0,16931,40.3,25092,25092,(X),6.8,21405,21405,12023,56.2,12023,56.2,11387,53.2,3929,3929,2635,67.1,8491,8491,5879,69.2
22101,40564,40564,22202,54.7,22125,54.5,20144,49.7,1981,4.9,77,0.2,18362,45.3,22125,22125,(X),9.0,20742,20742,9860,47.5,9860,47.5,9039,43.6,4052,4052,2520,62.2,7219,7219,4702,65.1
22103,197688,197688,125359,63.4,124831,63.1,117537,59.5,7294,3.7,528,0.3,72329,36.6,124831,124831,(X),5.8,103032,103032,59431,57.7,59350,57.6,55979,54.3,17937,17937,12622,70.4,40345,40345,29727,73.7
22105,101741,101741,60974,59.9,60903,59.9,55675,54.7,5228,5.1,71,0.1,40767,40.1,60903,60903,(X),8.6,53014,53014,28668,54.1,28668,54.1,26456,49.9,10476,10476,7180,68.5,19209,19209,13556,70.6
22107,3679,3679,1593,43.3,1593,43.3,1327,36.1,266,7.2,0,0.0,2086,56.7,1593,1593,(X),16.7,1927,1927,801,41.6,801,41.6,699,36.3,368,368,233,63.3,620,620,307,49.5
22109,87099,87099,50167,57.6,50039,57.5,46729,53.7,3310,3.8,128,0.1,36932,42.4,50039,50039,(X),6.6,44545,44545,22649,50.8,22618,50.8,21180,47.5,9362,9362,5992,64.0,17587,17587,11116,63.2
22111,18080,18080,8648,47.8,8636,47.8,8090,44.7,546,3.0,12,0.1,9432,52.2,8636,8636,(X),6.3,9202,9202,3566,38.8,3566,38.8,3335,36.2,1501,1501,718,47.8,2930,2930,1735,59.2
22113,46196,46196,26625,57.6,26625,57.6,24497,53.0,2128,4.6,0,0.0,19571,42.4,26625,26625,(X),8.0,24147,24147,12406,51.4,12406,51.4,11255,46.6,4852,4852,3587,73.9,9539,9539,5866,61.5
22115,39222,39222,24313,62.0,18825,48.0,17127,43.7,1698,4.3,5488,14.0,14909,38.0,18825,18825,(X),9.0,18016,18016,9062,50.3,8647,48.0,7829,43.5,4855,4855,2222,45.8,7182,7182,4040,56.3
22117,36752,36752,18752,51.0,18730,51.0,16678,45.4,2052,5.6,22,0.1,18000,49.0,18730,18730,(X),11.0,18770,18770,9129,48.6,9129,48.6,8279,44.1,3359,3359,2247,66.9,6805,6805,5057,74.3
22119,31754,31754,16286,51.3,16194,51.0,15292,48.2,902,2.8,92,0.3,15468,48.7,16194,16194,(X),5.6,16534,16534,7455,45.1,7443,45.0,7029,42.5,2829,2829,1524,53.9,5360,5360,3424,63.9
22121,20177,20177,13156,65.2,13119,65.0,12329,61.1,790,3.9,37,0.2,7021,34.8,13119,13119,(X),6.0,10230,10230,6444,63.0,6427,62.8,6049,59.1,2163,2163,1455,67.3,3909,3909,3093,79.1
22123,8886,8886,4141,46.6,4141,46.6,3690,41.5,451,5.1,0,0.0,4745,53.4,4141,4141,(X),10.9,4416,4416,1921,43.5,1921,43.5,1738,39.4,665,665,406,61.1,1683,1683,987,58.6
22125,13132,13132,6211,47.3,6211,47.3,5731,43.6,480,3.7,0,0.0,6921,52.7,6211,6211,(X),7.7,4503,4503,2514,55.8,2514,55.8,2353,52.3,786,786,482,61.3,1652,1652,969,58.7
22127,11833,11833,5326,45.0,5326,45.0,5083,43.0,243,2.1,0,0.0,6507,55.0,5326,5326,(X),4.6,5518,5518,2572,46.6,2572,46.6,2456,44.5,836,836,659,78.8,2025,2025,1191,58.8
23001,86464,86464,56687,65.6,56644,65.5,54039,62.5,2605,3.0,43,0.0,29777,34.4,56644,56644,(X),4.6,44704,44704,27820,62.2,27811,62.2,26603,59.5,7681,7681,5884,76.6,14748,14748,11417,77.4
23003,57370,57370,31368,54.7,31338,54.6,29745,51.8,1593,2.8,30,0.1,26002,45.3,31338,31338,(X),5.1,29271,29271,14625,50.0,14605,49.9,13980,47.8,3692,3692,2211,59.9,7952,7952,5500,69.2
23005,242041,242041,167360,69.1,166952,69.0,161323,66.7,5629,2.3,408,0.2,74681,30.9,166952,166952,(X),3.4,125863,125863,82410,65.5,82379,65.5,80013,63.6,16400,16400,12574,76.7,37290,37290,30121,80.8
23007,25172,25172,15174,60.3,15156,60.2,14291,56.8,865,3.4,18,0.1,9998,39.7,15156,15156,(X),5.7,13038,13038,7514,57.6,7514,57.6,7179,55.1,1597,1597,1036,64.9,3562,3562,2625,73.7
23009,46078,46078,28148,61.1,28053,60.9,26731,58.0,1322,2.9,95,0.2,17930,38.9,28053,28053,(X),4.7,23933,23933,14137,59.1,14136,59.1,13555,56.6,2729,2729,1867,68.4,6347,6347,5095,80.3
23011,100587,100587,62038,61.7,61956,61.6,58919,58.6,3037,3.0,82,0.1,38549,38.3,61956,61956,(X),4.9,52160,52160,30724,58.9,30723,58.9,29589,56.7,7123,7123,4901,68.8,15294,15294,11459,74.9
23013,33490,33490,21021,62.8,20976,62.6,20100,60.0,876,2.6,45,0.1,12469,37.2,20976,20976,(X),4.2,17056,17056,10425,61.1,10421,61.1,10168,59.6,1911,1911,1411,73.8,4923,4923,3969,80.6
23015,29121,29121,16957,58.2,16942,58.2,16304,56.0,638,2.2,15,0.1,12164,41.8,16942,16942,(X),3.8,15047,15047,8292,55.1,8291,55.1,8027,53.3,1626,1626,1047,64.4,3813,3813,2631,69.0
23017,47831,47831,27488,57.5,27480,57.5,25819,54.0,1661,3.5,8,0.0,20343,42.5,27480,27480,(X),6.0,24491,24491,13240,54.1,13240,54.1,12575,51.3,3142,3142,2126,67.7,7087,7087,5165,72.9
23019,127262,127262,77111,60.6,76881,60.4,72687,57.1,4194,3.3,230,0.2,50151,39.4,76881,76881,(X),5.5,64609,64609,37211,57.6,37188,57.6,35492,54.9,8341,8341,5857,70.2,17550,17550,13208,75.3
23021,14439,14439,6864,47.5,6864,47.5,6334,43.9,530,3.7,0,0.0,7575,52.5,6864,6864,(X),7.7,7240,7240,3224,44.5,3224,44.5,3001,41.5,834,834,455,54.6,1822,1822,999,54.8
23023,29374,29374,18982,64.6,18938,64.5,18442,62.8,496,1.7,44,0.1,10392,35.4,18938,18938,(X),2.6,15186,15186,9012,59.3,9012,59.3,8789,57.9,2057,2057,1555,75.6,4302,4302,3378,78.5
23025,42020,42020,24017,57.2,24001,57.1,21928,52.2,2073,4.9,16,0.0,18003,42.8,24001,24001,(X),8.6,21306,21306,11539,54.2,11539,54.2,10672,50.1,2675,2675,1746,65.3,6578,6578,4504,68.5
23027,32887,32887,20014,60.9,19925,60.6,18818,57.2,1107,3.4,89,0.3,12873,39.1,19925,19925,(X),5.6,16935,16935,9858,58.2,9851,58.2,9379,55.4,2053,2053,1355,66.0,4807,4807,3724,77.5
23029,26450,26450,13910,52.6,13840,52.3,12876,48.7,964,3.6,70,0.3,12540,47.4,13840,13840,(X),7.0,13529,13529,6592,48.7,6580,48.6,6170,45.6,1749,1749,1029,58.8,3797,3797,2510,66.1
23031,168771,168771,112041,66.4,111445,66.0,106832,63.3,4613,2.7,596,0.4,56730,33.6,111445,111445,(X),4.1,87602,87602,53956,61.6,53920,61.6,52092,59.5,11335,11335,8267,72.9,25319,25319,18765,74.1
24001,60855,60855,31543,51.8,31505,51.8,28820,47.4,2685,4.4,38,0.1,29312,48.2,31505,31505,(X),8.5,29122,29122,15084,51.8,15081,51.8,14025,48.2,3777,3777,2615,69.2,8038,8038,6402,79.6
24003,454073,454073,319263,70.3,306259,67.4,292038,64.3,14221,3.1,13004,2.9,134810,29.7,306259,306259,(X),4.6,230712,230712,151602,65.7,149084,64.6,142301,61.7,41193,41193,29531,71.7,80878,80878,62833,77.7
24005,668823,668823,442920,66.2,442139,66.1,419089,62.7,23050,3.4,781,0.1,225903,33.8,442139,442139,(X),5.2,357077,357077,221521,62.0,221235,62.0,210265,58.9,55862,55862,41200,73.8,113827,113827,88132,77.4
24009,72205,72205,50092,69.4,49309,68.3,46144,63.9,3165,4.4,783,1.1,22113,30.6,49309,49309,(X),6.4,36601,36601,23842,65.1,23709,64.8,22070,60.3,5469,5469,4077,74.5,14977,14977,11756,78.5
24011,25916,25916,16933,65.3,16923,65.3,16036,61.9,887,3.4,10,0.0,8983,34.7,16923,16923,(X),5.2,13403,13403,8042,60.0,8042,60.0,7692,57.4,2255,2255,1416,62.8,5051,5051,3666,72.6
24013,135303,135303,91348,67.5,91196,67.4,87999,65.0,3197,2.4,152,0.1,43955,32.5,91196,91196,(X),3.5,68948,68948,42621,61.8,42611,61.8,41247,59.8,10455,10455,7894,75.5,25361,25361,19505,76.9
24015,81668,81668,53507,65.5,53450,65.4,50467,61.8,2983,3.7,57,0.1,28161,34.5,53450,53450,(X),5.6,41417,41417,24816,59.9,24808,59.9,23537,56.8,6591,6591,4411,66.9,15645,15645,11825,75.6
24017,124325,124325,84199,67.7,82499,66.4,79180,63.7,3319,2.7,1700,1.4,40126,32.3,82499,82499,(X),4.0,65184,65184,41826,64.2,41488,63.6,39861,61.2,11319,11319,7572,66.9,25392,25392,19547,77.0
24019,26224,26224,16530,63.0,16516,63.0,15209,58.0,1307,5.0,14,0.1,9694,37.0,16516,16516,(X),7.9,13955,13955,8517,61.0,8517,61.0,7900,56.6,2053,2053,1670,81.3,4193,4193,3441,82.1
24021,197071,197071,138552,70.3,137863,70.0,131548,66.8,6315,3.2,689,0.3,58519,29.7,137863,137863,(X),4.6,100934,100934,65299,64.7,65243,64.6,62166,61.6,16764,16764,12048,71.9,39201,39201,29769,75.9
24023,24537,24537,14311,58.3,14304,58.3,13734,56.0,570,2.3,7,0.0,10226,41.7,14304,14304,(X),4.0,12499,12499,6625,53.0,6625,53.0,6404,51.2,1649,1649,948,57.5,3673,3673,2680,73.0
24025,201529,201529,137325,68.1,135662,67.3,129104,64.1,6558,3.3,1663,0.8,64204,31.9,135662,135662,(X),4.8,104015,104015,66062,63.5,65795,63.3,62724,60.3,17180,17180,12715,74.0,37454,37454,29123,77.8
24027,247203,247203,177687,71.9,175807,71.1,169065,68.4,6742,2.7,1880,0.8,69516,28.1,175807,175807,(X),3.8,127991,127991,85252,66.6,84737,66.2,81408,63.6,22167,22167,16061,72.5,53131,53131,40545,76.3
24029,16709,16709,9678,57.9,9664,57.8,9239,55.3,425,2.5,14,0.1,7031,42.1,9664,9664,(X),4.4,8802,8802,4798,54.5,4793,54.5,4608,52.4,962,962,690,71.7,1885,1885,1470,78.0
24031,823056,823056,588221,71.5,585038,71.1,556263,67.6,28775,3.5,3183,0.4,234835,28.5,585038,585038,(X),4.9,431505,431505,284691,66.0,283823,65.8,269374,62.4,77160,77160,56674,73.4,159188,159188,123996,77.9
24033,724261,724261,517764,71.5,515391,71.2,480863,66.4,34528,4.8,2373,0.3,206497,28.5,515391,515391,(X),6.7,380371,380371,257198,67.6,256721,67.5,239406,62.9,68709,68709,52133,75.9,124209,124209,100060,80.6
24035,39800,39800,26495,66.6,26404,66.3,25639,64.4,765,1.9,91,0.2,13305,33.4,26404,26404,(X),2.9,20195,20195,12566,62.2,12556,62.2,12172,60.3,2699,2699,2222,82.3,7646,7646,5746,75.2
24037,87163,87163,58741,67.4,56852,65.2,54788,62.9,2064,2.4,1889,2.2,28422,32.6,56852,56852,(X),3.6,43881,43881,26593,60.6,26419,60.2,25342,57.8,8013,8013,5367,67.0,18181,18181,12857,70.7
24039,21880,21880,9560,43.7,9560,43.7,8707,39.8,853,3.9,0,0.0,12320,56.3,9560,9560,(X),8.9,10014,10014,4862,48.6,4862,48.6,4420,44.1,1357,1357,815,60.1,2674,2674,1696,63.4
24041,31145,31145,18546,59.5,18520,59.5,17905,57.5,615,2.0,26,0.1,12599,40.5,18520,18520,(X),3.3,16530,16530,8960,54.2,8960,54.2,8678,52.5,2032,2032,1330,65.5,4553,4553,3784,83.1
24043,120544,120544,72102,59.8,71882,59.6,67191,55.7,4691,3.9,220,0.2,48442,40.2,71882,71882,(X),6.5,59253,59253,34252,57.8,34234,57.8,32183,54.3,9768,9768,6002,61.4,21469,21469,15235,71.0
24045,82281,82281,53374,64.9,53291,64.8,49229,59.8,4062,4.9,83,0.1,28907,35.1,53291,53291,(X),7.6,43853,43853,27460,62.6,27460,62.6,25302,57.7,7361,7361,5572,75.7,14119,14119,11382,80.6
24047,43674,43674,25428,58.2,25391,58.1,24042,55.0,1349,3.1,37,0.1,18246,41.8,25391,25391,(X),5.3,22606,22606,12249,54.2,12236,54.1,11679,51.7,2583,2583,2008,77.7,6017,6017,4177,69.4
24510,498965,498965,307536,61.6,306997,61.5,279034,55.9,27963,5.6,539,0.1,191429,38.4,306997,306997,(X),9.1,269052,269052,161495,60.0,161236,59.9,147726,54.9,45919,45919,32284,70.3,73397,73397,55000,74.9
25001,185069,185069,110790,59.9,110282,59.6,105075,56.8,5207,2.8,508,0.3,74279,40.1,110282,110282,(X),4.7,97394,97394,54671,56.1,54606,56.1,52555,54.0,8919,8919,6541,73.3,22051,22051,17421,79.0
25003,108363,108363,68344,63.1,68314,63.0,64233,59.3,4081,3.8,30,0.0,40019,36.9,68314,68314,(X),6.0,56532,56532,34208,60.5,34208,60.5,32670,57.8,6315,6315,5054,80.0,14158,14158,11763,83.1
25005,456450,456450,301151,66.0,300966,65.9,283422,62.1,17544,3.8,185,0.0,155299,34.0,300966,300966,(X),5.8,237938,237938,148828,62.5,148761,62.5,140794,59.2,34436,34436,25600,74.3,76560,76560,60041,78.4
25007,14441,14441,8977,62.2,8970,62.1,8684,60.1,286,2.0,7,0.0,5464,37.8,8970,8970,(X),3.2,7391,7391,4488,60.7,4488,60.7,4271,57.8,780,780,659,84.5,2409,2409,2167,90.0
25009,633115,633115,426777,67.4,426401,67.3,403439,63.7,22962,3.6,376,0.1,206338,32.6,426401,426401,(X),5.4,332513,332513,210196,63.2,210190,63.2,199783,60.1,51052,51052,37655,73.8,112128,112128,85722,76.5
25011,59969,59969,38994,65.0,38991,65.0,36982,61.7,2009,3.4,3,0.0,20975,35.0,38991,38991,(X),5.2,31054,31054,19589,63.1,19586,63.1,18736,60.3,3586,3586,2665,74.3,8256,8256,6658,80.6
25013,378775,378775,232340,61.3,231939,61.2,216101,57.1,15838,4.2,401,0.1,146435,38.7,231939,231939,(X),6.8,198440,198440,114072,57.5,114031,57.5,107230,54.0,30505,30505,20000,65.6,66769,66769,48030,71.9
25015,140238,140238,89695,64.0,89520,63.8,84200,60.0,5320,3.8,175,0.1,50543,36.0,89520,89520,(X),5.9,75553,75553,47026,62.2,47026,62.2,44761,59.2,6639,6639,4840,72.9,16554,16554,13625,82.3
25017,1312708,1312708,916814,69.8,915319,69.7,876744,66.8,38575,2.9,1495,0.1,395894,30.2,915319,915319,(X),4.2,676735,676735,443091,65.5,442911,65.4,424532,62.7,102723,102723,73421,71.5,209826,209826,159865,76.2
25019,9028,9028,6682,74.0,6654,73.7,6471,71.7,183,2.0,28,0.3,2346,26.0,6654,6654,(X),2.8,4407,4407,3079,69.9,3079,69.9,3030,68.8,774,774,587,75.8,1512,1512,1260,83.3
25021,568020,568020,391756,69.0,391537,68.9,371989,65.5,19548,3.4,219,0.0,176264,31.0,391537,391537,(X),5.0,299019,299019,192865,64.5,192847,64.5,183659,61.4,44378,44378,32298,72.8,100616,100616,75907,75.4
25023,414111,414111,280026,67.6,279842,67.6,264683,63.9,15159,3.7,184,0.0,134085,32.4,279842,279842,(X),5.4,215220,215220,137013,63.7,136991,63.7,130234,60.5,31772,31772,23597,74.3,76167,76167,60180,79.0
25025,671930,671930,462603,68.8,461751,68.7,429529,63.9,32222,4.8,852,0.1,209327,31.2,461751,461751,(X),7.0,349760,349760,230501,65.9,230397,65.9,215493,61.6,48367,48367,36108,74.7,79803,79803,60573,75.9
25027,667774,667774,443693,66.4,443235,66.4,418705,62.7,24530,3.7,458,0.1,224081,33.6,443235,443235,(X),5.5,341653,341653,213459,62.5,213392,62.5,202791,59.4,51169,51169,36764,71.8,118050,118050,90915,77.0
26001,9219,9219,3707,40.2,3703,40.2,3372,36.6,331,3.6,4,0.0,5512,59.8,3703,3703,(X),8.9,4560,4560,1735,38.0,1735,38.0,1594,35.0,350,350,245,70.0,850,850,601,70.7
26003,7953,7953,3330,41.9,3330,41.9,3112,39.1,218,2.7,0,0.0,4623,58.1,3330,3330,(X),6.5,3518,3518,1543,43.9,1543,43.9,1474,41.9,384,384,298,77.6,897,897,730,81.4
26005,90379,90379,56750,62.8,56729,62.8,54935,60.8,1794,2.0,21,0.0,33629,37.2,56729,56729,(X),3.2,45599,45599,25927,56.9,25927,56.9,25144,55.1,8232,8232,5049,61.3,18922,18922,13220,69.9
26007,23893,23893,13364,55.9,13322,55.8,12522,52.4,800,3.3,42,0.2,10529,44.1,13322,13322,(X),6.0,12174,12174,6328,52.0,6318,51.9,6005,49.3,1435,1435,1016,70.8,3552,3552,2690,75.7
26009,19444,19444,10360,53.3,10360,53.3,9807,50.4,553,2.8,0,0.0,9084,46.7,10360,10360,(X),5.3,9872,9872,4829,48.9,4829,48.9,4634,46.9,1145,1145,811,70.8,2767,2767,2046,73.9
26011,12756,12756,6354,49.8,6354,49.8,5747,45.1,607,4.8,0,0.0,6402,50.2,6354,6354,(X),9.6,6309,6309,3057,48.5,3057,48.5,2862,45.4,762,762,523,68.6,1832,1832,1279,69.8
26013,7161,7161,2961,41.3,2961,41.3,2772,38.7,189,2.6,0,0.0,4200,58.7,2961,2961,(X),6.4,3141,3141,1583,50.4,1583,50.4,1506,47.9,385,385,276,71.7,1032,1032,754,73.1
26015,48255,48255,29774,61.7,29752,61.7,28209,58.5,1543,3.2,22,0.0,18481,38.3,29752,29752,(X),5.2,24004,24004,13472,56.1,13468,56.1,12893,53.7,3777,3777,2650,70.2,9135,9135,6809,74.5
26017,85860,85860,50245,58.5,50224,58.5,46741,54.4,3483,4.1,21,0.0,35615,41.5,50224,50224,(X),6.9,44087,44087,24115,54.7,24115,54.7,22856,51.8,5917,5917,4236,71.6,14605,14605,11495,78.7
26019,14720,14720,8314,56.5,8288,56.3,7827,53.2,461,3.1,26,0.2,6406,43.5,8288,8288,(X),5.6,7481,7481,3982,53.2,3970,53.1,3849,51.5,900,900,561,62.3,2151,2151,1659,77.1
26021,124462,124462,76464,61.4,76442,61.4,71586,57.5,4856,3.9,22,0.0,47998,38.6,76442,76442,(X),6.4,64193,64193,35825,55.8,35822,55.8,33618,52.4,10390,10390,7071,68.1,21656,21656,15872,73.3
26023,34623,34623,19736,57.0,19736,57.0,18842,54.4,894,2.6,0,0.0,14887,43.0,19736,19736,(X),4.5,16715,16715,9023,54.0,9023,54.0,8596,51.4,3101,3101,1758,56.7,6390,6390,4075,63.8
26025,106909,106909,63224,59.1,63093,59.0,58671,54.9,4422,4.1,131,0.1,43685,40.9,63093,63093,(X),7.0,55262,55262,31177,56.4,31146,56.4,29041,52.6,9248,9248,6235,67.4,19896,19896,15042,75.6
26027,42104,42104,25466,60.5,25466,60.5,23766,56.4,1700,4.0,0,0.0,16638,39.5,25466,25466,(X),6.7,21170,21170,11447,54.1,11447,54.1,10697,50.5,2942,2942,1867,63.5,7224,7224,5008,69.3
26029,21659,21659,12839,59.3,12812,59.2,12240,56.5,572,2.6,27,0.1,8820,40.7,12812,12812,(X),4.5,11023,11023,6007,54.5,6005,54.5,5785,52.5,1346,1346,852,63.3,3469,3469,2614,75.4
26031,21749,21749,11540,53.1,11439,52.6,10503,48.3,936,4.3,101,0.5,10209,46.9,11439,11439,(X),8.2,10960,10960,5433,49.6,5423,49.5,5072,46.3,1185,1185,770,65.0,2919,2919,1872,64.1
26033,31729,31729,16907,53.3,16729,52.7,15179,47.8,1550,4.9,178,0.6,14822,46.7,16729,16729,(X),9.3,14135,14135,7685,54.4,7643,54.1,6951,49.2,2148,2148,1338,62.3,4531,4531,3276,72.3
26035,25294,25294,12145,48.0,12145,48.0,10915,43.2,1230,4.9,0,0.0,13149,52.0,12145,12145,(X),10.1,12802,12802,5669,44.3,5669,44.3,5149,40.2,1987,1987,1014,51.0,3777,3777,2121,56.2
26037,62427,62427,39341,63.0,39303,63.0,37744,60.5,1559,2.5,38,0.1,23086,37.0,39303,39303,(X),4.0,31754,31754,18502,58.3,18502,58.3,17925,56.4,5004,5004,3463,69.2,11974,11974,8840,73.8
26039,11678,11678,5754,49.3,5736,49.1,5267,45.1,469,4.0,18,0.2,5924,50.7,5736,5736,(X),8.2,5723,5723,2684,46.9,2684,46.9,2523,44.1,644,644,513,79.7,1687,1687,1158,68.6
26041,29857,29857,16567,55.5,16524,55.3,15640,52.4,884,3.0,43,0.1,13290,44.5,16524,16524,(X),5.3,15108,15108,7947,52.6,7947,52.6,7578,50.2,2066,2066,1272,61.6,4918,4918,3665,74.5
26043,21117,21117,11800,55.9,11788,55.8,11274,53.4,514,2.4,12,0.1,9317,44.1,11788,11788,(X),4.4,10570,10570,5253,49.7,5241,49.6,5052,47.8,1503,1503,969,64.5,3353,3353,2337,69.7
26045,88864,88864,55960,63.0,55855,62.9,52908,59.5,2947,3.3,105,0.1,32904,37.0,55855,55855,(X),5.3,45874,45874,27189,59.3,27143,59.2,25944,56.6,7129,7129,5367,75.3,14680,14680,11307,77.0
26047,27345,27345,17462,63.9,17445,63.8,16567,60.6,878,3.2,17,0.1,9883,36.1,17445,17445,(X),5.0,14019,14019,8414,60.0,8401,59.9,8012,57.2,1798,1798,1374,76.4,4574,4574,3502,76.6
26049,326640,326640,188362,57.7,188265,57.6,169798,52.0,18467,5.7,97,0.0,138278,42.3,188265,188265,(X),9.8,171459,171459,92628,54.0,92613,54.0,84211,49.1,28171,28171,18699,66.4,61210,61210,44583,72.8
26051,21081,21081,9419,44.7,9415,44.7,8757,41.5,658,3.1,4,0.0,11662,55.3,9415,9415,(X),7.0,10490,10490,4217,40.2,4217,40.2,3941,37.6,1458,1458,775,53.2,3068,3068,1891,61.6
26053,13363,13363,6374,47.7,6366,47.6,6008,45.0,358,2.7,8,0.1,6989,52.3,6366,6366,(X),5.6,6106,6106,2937,48.1,2937,48.1,2783,45.6,657,657,357,54.3,1641,1641,1217,74.2
26055,75135,75135,48679,64.8,48479,64.5,46120,61.4,2359,3.1,200,0.3,26456,35.2,48479,48479,(X),4.9,38276,38276,23392,61.1,23392,61.1,22230,58.1,5531,5531,3854,69.7,12362,12362,9547,77.2
26057,33817,33817,17206,50.9,17202,50.9,16042,47.4,1160,3.4,4,0.0,16611,49.1,17202,17202,(X),6.7,15634,15634,8420,53.9,8420,53.9,7896,50.5,2332,2332,1644,70.5,5553,5553,4183,75.3
26059,36957,36957,20405,55.2,20393,55.2,19370,52.4,1023,2.8,12,0.0,16552,44.8,20393,20393,(X),5.0,18629,18629,9398,50.4,9395,50.4,8936,48.0,3080,3080,1853,60.2,6366,6366,4226,66.4
26061,29910,29910,16315,54.5,16308,54.5,15245,51.0,1063,3.6,7,0.0,13595,45.5,16308,16308,(X),6.5,13588,13588,7260,53.4,7260,53.4,6953,51.2,2317,2317,1503,64.9,4812,4812,3031,63.0
26063,26203,26203,14756,56.3,14740,56.3,13946,53.2,794,3.0,16,0.1,11447,43.7,14740,14740,(X),5.4,13258,13258,6735,50.8,6735,50.8,6424,48.5,1865,1865,1348,72.3,4010,4010,3014,75.2
26065,238360,238360,151898,63.7,151734,63.7,140932,59.1,10802,4.5,164,0.1,86462,36.3,151734,151734,(X),7.1,123466,123466,74515,60.4,74499,60.3,69520,56.3,19013,19013,12849,67.6,36019,36019,26281,73.0
26067,51017,51017,30066,58.9,30037,58.9,28461,55.8,1576,3.1,29,0.1,20951,41.1,30037,30037,(X),5.2,23672,23672,13873,58.6,13858,58.5,13090,55.3,4227,4227,2723,64.4,10045,10045,6942,69.1
26069,21565,21565,10087,46.8,10059,46.6,9238,42.8,821,3.8,28,0.1,11478,53.2,10059,10059,(X),8.2,10814,10814,4611,42.6,4611,42.6,4257,39.4,1267,1267,803,63.4,2665,2665,1835,68.9
26071,9627,9627,4693,48.7,4685,48.7,4402,45.7,283,2.9,8,0.1,4934,51.3,4685,4685,(X),6.0,4815,4815,2186,45.4,2183,45.3,2107,43.8,529,529,321,60.7,1162,1162,787,67.7
26073,59956,59956,36871,61.5,36871,61.5,34086,56.9,2785,4.6,0,0.0,23085,38.5,36871,36871,(X),7.6,31023,31023,18634,60.1,18634,60.1,17345,55.9,3774,3774,2664,70.6,7617,7617,5880,77.2
26075,128750,128750,72873,56.6,72782,56.5,67825,52.7,4957,3.9,91,0.1,55877,43.4,72782,72782,(X),6.8,63167,63167,35058,55.5,35045,55.5,32836,52.0,10291,10291,7149,69.5,22158,22158,16916,76.3
26077,210542,210542,139963,66.5,139824,66.4,131460,62.4,8364,4.0,139,0.1,70579,33.5,139824,139824,(X),6.0,108554,108554,68564,63.2,68499,63.1,65170,60.0,17833,17833,12939,72.6,36258,36258,27032,74.6
26079,14228,14228,7837,55.1,7826,55.0,7236,50.9,590,4.1,11,0.1,6391,44.9,7826,7826,(X),7.5,6987,6987,3514,50.3,3506,50.2,3312,47.4,1024,1024,619,60.4,2365,2365,1593,67.4
26081,502256,502256,346227,68.9,346056,68.9,329336,65.6,16720,3.3,171,0.0,156029,31.1,346056,346056,(X),4.8,257569,257569,164011,63.7,163979,63.7,156126,60.6,50504,50504,34692,68.7,100941,100941,74926,74.2
26083,1852,1852,898,48.5,898,48.5,844,45.6,54,2.9,0,0.0,954,51.5,898,898,(X),6.0,887,887,364,41.0,364,41.0,345,38.9,113,113,57,50.4,217,217,151,69.6
26085,10072,10072,4057,40.3,4057,40.3,3564,35.4,493,4.9,0,0.0,6015,59.7,4057,4057,(X),12.2,4926,4926,1988,40.4,1988,40.4,1822,37.0,537,537,288,53.6,1253,1253,793,63.3
26087,71827,71827,41843,58.3,41843,58.3,39162,54.5,2681,3.7,0,0.0,29984,41.7,41843,41843,(X),6.4,35421,35421,18785,53.0,18785,53.0,17512,49.4,5102,5102,3053,59.8,12859,12859,8928,69.4
26089,18583,18583,10323,55.6,10323,55.6,9774,52.6,549,3.0,0,0.0,8260,44.4,10323,10323,(X),5.3,9470,9470,4816,50.9,4816,50.9,4615,48.7,1026,1026,698,68.0,2308,2308,1734,75.1
26091,80013,80013,46810,58.5,46739,58.4,44374,55.5,2365,3.0,71,0.1,33203,41.5,46739,46739,(X),5.1,39700,39700,22130,55.7,22130,55.7,21038,53.0,6054,6054,4116,68.0,14001,14001,10283,73.4
26093,152617,152617,100673,66.0,100618,65.9,96375,63.1,4243,2.8,55,0.0,51944,34.0,100618,100618,(X),4.2,76580,76580,46217,60.4,46210,60.3,44109,57.6,11416,11416,7555,66.2,28836,28836,21244,73.7
26095,5450,5450,2239,41.1,2239,41.1,2111,38.7,128,2.3,0,0.0,3211,58.9,2239,2239,(X),5.7,2191,2191,1055,48.2,1055,48.2,995,45.4,304,304,171,56.3,690,690,454,65.8
26097,9293,9293,5118,55.1,5092,54.8,4593,49.4,499,5.4,26,0.3,4175,44.9,5092,5092,(X),9.8,4644,4644,2444,52.6,2444,52.6,2207,47.5,459,459,301,65.6,1135,1135,881,77.6
26099,705357,705357,448653,63.6,448126,63.5,422419,59.9,25707,3.6,527,0.1,256704,36.4,448126,448126,(X),5.7,366252,366252,212772,58.1,212712,58.1,200922,54.9,56380,56380,38001,67.4,124446,124446,91154,73.2
26101,20741,20741,10176,49.1,10172,49.0,9444,45.5,728,3.5,4,0.0,10565,50.9,10172,10172,(X),7.2,9983,9983,4850,48.6,4850,48.6,4584,45.9,1122,1122,718,64.0,2908,2908,2157,74.2
26103,56149,56149,32032,57.0,31891,56.8,29934,53.3,1957,3.5,141,0.3,24117,43.0,31891,31891,(X),6.1,27999,27999,15318,54.7,15271,54.5,14542,51.9,3711,3711,2789,75.2,7623,7623,5521,72.4
26105,23640,23640,13419,56.8,13396,56.7,12582,53.2,814,3.4,23,0.1,10221,43.2,13396,13396,(X),6.1,12016,12016,6279,52.3,6256,52.1,5982,49.8,1705,1705,1084,63.6,3818,3818,2781,72.8
26107,36239,36239,20039,55.3,20039,55.3,18646,51.5,1393,3.8,0,0.0,16200,44.7,20039,20039,(X),7.0,18068,18068,9737,53.9,9737,53.9,9081,50.3,2425,2425,1460,60.2,5212,5212,3501,67.2
26109,19365,19365,11401,58.9,11400,58.9,10902,56.3,498,2.6,1,0.0,7964,41.1,11400,11400,(X),4.4,9615,9615,5353,55.7,5353,55.7,5161,53.7,1271,1271,982,77.3,2910,2910,2346,80.6
26111,67652,67652,40705,60.2,40684,60.1,38234,56.5,2450,3.6,21,0.0,26947,39.8,40684,40684,(X),6.0,34658,34658,19240,55.5,19240,55.5,18171,52.4,5468,5468,4067,74.4,11852,11852,8712,73.5
26113,11935,11935,6635,55.6,6633,55.6,6213,52.1,420,3.5,2,0.0,5300,44.4,6633,6633,(X),6.3,5853,5853,2963,50.6,2963,50.6,2777,47.4,1100,1100,618,56.2,2206,2206,1575,71.4
26115,121468,121468,73995,60.9,73930,60.9,70306,57.9,3624,3.0,65,0.1,47473,39.1,73930,73930,(X),4.9,61810,61810,34369,55.6,34369,55.6,32846,53.1,9304,9304,6101,65.6,21957,21957,16632,75.7
26117,50575,50575,28398,56.2,28372,56.1,26929,53.2,1443,2.9,26,0.1,22177,43.8,28372,28372,(X),5.1,24442,24442,13035,53.3,13031,53.3,12348,50.5,4111,4111,2497,60.7,9520,9520,6603,69.4
26119,8036,8036,3273,40.7,3273,40.7,2894,36.0,379,4.7,0,0.0,4763,59.3,3273,3273,(X),11.6,3996,3996,1544,38.6,1544,38.6,1420,35.5,358,358,196,54.7,859,859,462,53.8
26121,137058,137058,80054,58.4,80025,58.4,74113,54.1,5912,4.3,29,0.0,57004,41.6,80025,80025,(X),7.4,69278,69278,38693,55.9,38684,55.8,36096,52.1,12120,12120,8194,67.6,25932,25932,19821,76.4
26123,38446,38446,21074,54.8,21073,54.8,19795,51.5,1278,3.3,1,0.0,17372,45.2,21073,21073,(X),6.1,19231,19231,9868,51.3,9868,51.3,9318,48.5,3291,3291,2020,61.4,6919,6919,4791,69.2
26125,1015249,1015249,671323,66.1,671024,66.1,638789,62.9,32235,3.2,299,0.0,343926,33.9,671024,671024,(X),4.8,525205,525205,313857,59.8,313800,59.7,298688,56.9,80776,80776,53538,66.3,180526,180526,128702,71.3
26127,20949,20949,11566,55.2,11559,55.2,10708,51.1,851,4.1,7,0.0,9383,44.8,11559,11559,(X),7.4,10332,10332,5249,50.8,5249,50.8,4877,47.2,1782,1782,1049,58.9,3984,3984,2594,65.1
26129,17560,17560,8405,47.9,8395,47.8,7720,44.0,675,3.8,10,0.1,9155,52.1,8395,8395,(X),8.0,8815,8815,3958,44.9,3958,44.9,3744,42.5,1053,1053,634,60.2,2442,2442,1620,66.3
26131,5320,5320,2228,41.9,2226,41.8,2066,38.8,160,3.0,2,0.0,3092,58.1,2226,2226,(X),7.2,2601,2601,1063,40.9,1063,40.9,1021,39.3,158,158,84,53.2,548,548,358,65.3
26133,18644,18644,9674,51.9,9671,51.9,9003,48.3,668,3.6,3,0.0,8970,48.1,9671,9671,(X),6.9,9348,9348,4504,48.2,4504,48.2,4253,45.5,1429,1429,879,61.5,3481,3481,2127,61.1
26135,6903,6903,3230,46.8,3230,46.8,2839,41.1,391,5.7,0,0.0,3673,53.2,3230,3230,(X),12.1,3413,3413,1445,42.3,1445,42.3,1306,38.3,463,463,210,45.4,1043,1043,553,53.0
26137,19908,19908,11577,58.2,11564,58.1,10915,54.8,649,3.3,13,0.1,8331,41.8,11564,11564,(X),5.6,10119,10119,5540,54.7,5540,54.7,5222,51.6,1541,1541,1214,78.8,3460,3460,2588,74.8
26139,222988,222988,153196,68.7,153122,68.7,147178,66.0,5944,2.7,74,0.0,69792,31.3,153122,153122,(X),3.9,113991,113991,71503,62.7,71490,62.7,68940,60.5,20901,20901,14555,69.6,45729,45729,35089,76.7
26141,11034,11034,5119,46.4,5119,46.4,4664,42.3,455,4.1,0,0.0,5915,53.6,5119,5119,(X),8.9,5506,5506,2401,43.6,2401,43.6,2215,40.2,520,520,399,76.7,1434,1434,992,69.2
26143,20715,20715,8565,41.3,8565,41.3,7595,36.7,970,4.7,0,0.0,12150,58.7,8565,8565,(X),11.3,10485,10485,4233,40.4,4233,40.4,3841,36.6,951,951,689,72.5,2440,2440,1442,59.1
26145,156480,156480,89345,57.1,89316,57.1,82611,52.8,6705,4.3,29,0.0,67135,42.9,89316,89316,(X),7.5,81528,81528,44755,54.9,44755,54.9,41962,51.5,12614,12614,9182,72.8,26350,26350,20126,76.4
26147,129811,129811,78507,60.5,78473,60.5,73196,56.4,5277,4.1,34,0.0,51304,39.5,78473,78473,(X),6.7,65836,65836,36500,55.4,36500,55.4,34107,51.8,9229,9229,6483,70.2,23115,23115,16327,70.6
26149,47609,47609,29562,62.1,29551,62.1,28021,58.9,1530,3.2,11,0.0,18047,37.9,29551,29551,(X),5.2,24174,24174,13428,55.5,13428,55.5,12892,53.3,4484,4484,2686,59.9,9559,9559,6974,73.0
26151,33608,33608,19162,57.0,19150,57.0,17802,53.0,1348,4.0,12,0.0,14446,43.0,19150,19150,(X),7.0,17004,17004,8706,51.2,8704,51.2,8240,48.5,2514,2514,1612,64.1,5968,5968,4007,67.1
26153,6844,6844,3134,45.8,3129,45.7,2807,41.0,322,4.7,5,0.1,3710,54.2,3129,3129,(X),10.3,3474,3474,1505,43.3,1505,43.3,1368,39.4,397,397,273,68.8,946,946,658,69.6
26155,55780,55780,33510,60.1,33497,60.1,31824,57.1,1673,3.0,13,0.0,22270,39.9,33497,33497,(X),5.0,28399,28399,15747,55.4,15744,55.4,15032,52.9,3973,3973,2769,69.7,10145,10145,7639,75.3
26157,43490,43490,24414,56.1,24400,56.1,22830,52.5,1570,3.6,14,0.0,19076,43.9,24400,24400,(X),6.4,21912,21912,11301,51.6,11290,51.5,10708,48.9,3207,3207,2093,65.3,7036,7036,4843,68.8
26159,59660,59660,36439,61.1,36416,61.0,34169,57.3,2247,3.8,23,0.0,23221,38.9,36416,36416,(X),6.2,30196,30196,17108,56.7,17096,56.6,16161,53.5,5154,5154,3504,68.0,11428,11428,8387,73.4
26161,304911,304911,197052,64.6,196929,64.6,187609,61.5,9320,3.1,123,0.0,107859,35.4,196929,196929,(X),4.7,154932,154932,93568,60.4,93562,60.4,89280,57.6,21055,21055,14241,67.6,45840,45840,33068,72.1
26163,1389038,1389038,818148,58.9,817808,58.9,734480,52.9,83328,6.0,340,0.0,570890,41.1,817808,817808,(X),10.2,731147,731147,401304,54.9,401240,54.9,362301,49.6,131718,131718,82342,62.5,266210,266210,176595,66.3
26165,26216,26216,14950,57.0,14950,57.0,14045,53.6,905,3.5,0,0.0,11266,43.0,14950,14950,(X),6.1,13155,13155,6782,51.6,6782,51.6,6408,48.7,2228,2228,1316,59.1,5149,5149,3872,75.2
27001,13531,13531,6601,48.8,6599,48.8,6207,45.9,392,2.9,2,0.0,6930,51.2,6599,6599,(X),5.9,6712,6712,3157,47.0,3157,47.0,2994,44.6,683,683,471,69.0,1779,1779,1375,77.3
27003,273199,273199,197507,72.3,197341,72.2,189965,69.5,7376,2.7,166,0.1,75692,27.7,197341,197341,(X),3.7,137393,137393,94151,68.5,94142,68.5,91081,66.3,25791,25791,19952,77.4,55375,55375,44956,81.2
27005,26422,26422,17015,64.4,17012,64.4,16399,62.1,613,2.3,3,0.0,9407,35.6,17012,17012,(X),3.6,13290,13290,8026,60.4,8026,60.4,7752,58.3,2616,2616,1882,71.9,5186,5186,3909,75.4
27007,35538,35538,22884,64.4,22868,64.3,21100,59.4,1768,5.0,16,0.0,12654,35.6,22868,22868,(X),7.7,18004,18004,11396,63.3,11393,63.3,10741,59.7,3797,3797,2858,75.3,6564,6564,5455,83.1
27009,30632,30632,21619,70.6,21594,70.5,20722,67.6,872,2.8,25,0.1,9013,29.4,21594,21594,(X),4.0,15269,15269,10079,66.0,10061,65.9,9791,64.1,3431,3431,2653,77.3,6135,6135,4877,79.5
27011,4079,4079,2454,60.2,2454,60.2,2398,58.8,56,1.4,0,0.0,1625,39.8,2454,2454,(X),2.3,2078,2078,1090,52.5,1090,52.5,1067,51.3,318,318,261,82.1,714,714,621,87.0
27013,54617,54617,39138,71.7,39107,71.6,37545,68.7,1562,2.9,31,0.1,15479,28.3,39107,39107,(X),4.0,27362,27362,19086,69.8,19086,69.8,18396,67.2,4472,4472,3589,80.3,8184,8184,6776,82.8
27015,20355,20355,13927,68.4,13926,68.4,13652,67.1,274,1.3,1,0.0,6428,31.6,13926,13926,(X),2.0,10382,10382,6499,62.6,6499,62.6,6367,61.3,1603,1603,1421,88.6,3749,3749,3170,84.6
27017,28339,28339,17401,61.4,17373,61.3,16640,58.7,733,2.6,28,0.1,10938,38.6,17373,17373,(X),4.2,13553,13553,8165,60.2,8161,60.2,7926,58.5,2256,2256,1503,66.6,5449,5449,4574,83.9
27019,76390,76390,57476,75.2,57474,75.2,56258,73.6,1216,1.6,2,0.0,18914,24.8,57474,57474,(X),2.1,38837,38837,27137,69.9,27137,69.9,26687,68.7,8101,8101,6164,76.1,18791,18791,15291,81.4
27021,23486,23486,13007,55.4,12989,55.3,12283,52.3,706,3.0,18,0.1,10479,44.6,12989,12989,(X),5.4,11599,11599,6143,53.0,6143,53.0,5893,50.8,1817,1817,1298,71.4,3704,3704,2754,74.4
27023,9536,9536,6298,66.0,6298,66.0,6127,64.3,171,1.8,0,0.0,3238,34.0,6298,6298,(X),2.7,4876,4876,2935,60.2,2935,60.2,2865,58.8,927,927,722,77.9,1717,1717,1352,78.7
27025,43651,43651,29996,68.7,29993,68.7,28762,65.9,1231,2.8,3,0.0,13655,31.3,29993,29993,(X),4.1,21042,21042,14227,67.6,14224,67.6,13753,65.4,3580,3580,2731,76.3,8692,8692,7341,84.5
27027,49204,49204,35130,71.4,35067,71.3,34144,69.4,923,1.9,63,0.1,14074,28.6,35067,35067,(X),2.6,25191,25191,17278,68.6,17266,68.5,16920,67.2,5185,5185,4156,80.2,9518,9518,7635,80.2
27029,6908,6908,4116,59.6,4116,59.6,3790,54.9,326,4.7,0,0.0,2792,40.4,4116,4116,(X),7.9,3399,3399,1898,55.8,1898,55.8,1807,53.2,579,579,326,56.3,1399,1399,1026,73.3
27031,4627,4627,2688,58.1,2688,58.1,2614,56.5,74,1.6,0,0.0,1939,41.9,2688,2688,(X),2.8,2343,2343,1276,54.5,1276,54.5,1263,53.9,274,274,210,76.6,521,521,430,82.5
27033,8916,8916,5624,63.1,5624,63.1,5395,60.5,229,2.6,0,0.0,3292,36.9,5624,5624,(X),4.1,4512,4512,2579,57.2,2579,57.2,2495,55.3,906,906,649,71.6,1752,1752,1267,72.3
27035,51518,51518,31352,60.9,31246,60.7,30366,58.9,880,1.7,106,0.2,20166,39.1,31246,31246,(X),2.8,26033,26033,14913,57.3,14913,57.3,14633,56.2,4187,4187,3220,76.9,9285,9285,7214,77.7
27037,326981,326981,241861,74.0,241542,73.9,232877,71.2,8665,2.7,319,0.1,85120,26.0,241542,241542,(X),3.6,167768,167768,117033,69.8,116971,69.7,113022,67.4,32826,32826,25497,77.7,68035,68035,55540,81.6
27039,15703,15703,11607,73.9,11605,73.9,11309,72.0,296,1.9,2,0.0,4096,26.1,11605,11605,(X),2.6,7860,7860,5470,69.6,5470,69.6,5351,68.1,1518,1518,1334,87.9,3752,3752,3275,87.3
27041,30116,30116,19824,65.8,19819,65.8,19219,63.8,600,2.0,5,0.0,10292,34.2,19819,19819,(X),3.0,15079,15079,9175,60.8,9175,60.8,9005,59.7,2443,2443,1946,79.7,5371,5371,4482,83.4
27043,11168,11168,7317,65.5,7316,65.5,7082,63.4,234,2.1,1,0.0,3851,34.5,7316,7316,(X),3.2,5627,5627,3412,60.6,3412,60.6,3291,58.5,972,972,747,76.9,1851,1851,1478,79.8
27045,16322,16322,10958,67.1,10958,67.1,10666,65.3,292,1.8,0,0.0,5364,32.9,10958,10958,(X),2.7,8237,8237,5083,61.7,5083,61.7,4966,60.3,1591,1591,1111,69.8,3382,3382,2749,81.3
27047,24609,24609,15884,64.5,15882,64.5,15190,61.7,692,2.8,2,0.0,8725,35.5,15882,15882,(X),4.4,12425,12425,7329,59.0,7329,59.0,6981,56.2,2037,2037,1516,74.4,4340,4340,3375,77.8
27049,37119,37119,24930,67.2,24922,67.1,24004,64.7,918,2.5,8,0.0,12189,32.8,24922,24922,(X),3.7,18725,18725,11708,62.5,11708,62.5,11260,60.1,3208,3208,2473,77.1,6872,6872,5563,81.0
27051,4723,4723,3039,64.3,3039,64.3,2916,61.7,123,2.6,0,0.0,1684,35.7,3039,3039,(X),4.0,2310,2310,1353,58.6,1353,58.6,1305,56.5,387,387,285,73.6,870,870,701,80.6
27053,990445,990445,717917,72.5,717635,72.5,687713,69.4,29922,3.0,282,0.0,272528,27.5,717635,717635,(X),4.2,504721,504721,345548,68.5,345522,68.5,332155,65.8,92132,92132,69400,75.3,169959,169959,132210,77.8
27055,15067,15067,10367,68.8,10367,68.8,10164,67.5,203,1.3,0,0.0,4700,31.2,10367,10367,(X),2.0,7629,7629,5061,66.3,5061,66.3,4995,65.5,1233,1233,959,77.8,2681,2681,2444,91.2
27057,16950,16950,9952,58.7,9950,58.7,9600,56.6,350,2.1,2,0.0,6998,41.3,9950,9950,(X),3.5,8392,8392,4732,56.4,4732,56.4,4588,54.7,1391,1391,985,70.8,2753,2753,2126,77.2
27059,30498,30498,20863,68.4,20854,68.4,19894,65.2,960,3.1,9,0.0,9635,31.6,20854,20854,(X),4.6,15134,15134,9846,65.1,9842,65.0,9441,62.4,2753,2753,1950,70.8,6172,6172,4920,79.7
27061,36924,36924,21311,57.7,21303,57.7,20192,54.7,1111,3.0,8,0.0,15613,42.3,21303,21303,(X),5.2,18400,18400,10258,55.8,10258,55.8,9841,53.5,2787,2787,1766,63.4,6056,6056,4302,71.0
27063,8060,8060,5490,68.1,5490,68.1,5320,66.0,170,2.1,0,0.0,2570,31.9,5490,5490,(X),3.1,4017,4017,2555,63.6,2555,63.6,2505,62.4,711,711,561,78.9,1362,1362,1068,78.4
27065,12986,12986,8115,62.5,8113,62.5,7742,59.6,371,2.9,2,0.0,4871,37.5,8113,8113,(X),4.6,6371,6371,3754,58.9,3754,58.9,3684,57.8,991,991,650,65.6,2225,2225,1749,78.6
27067,33387,33387,22464,67.3,22462,67.3,21779,65.2,683,2.0,2,0.0,10923,32.7,22462,22462,(X),3.0,16722,16722,10445,62.5,10443,62.5,10107,60.4,3275,3275,2153,65.7,6614,6614,5318,80.4
27069,3516,3516,2306,65.6,2306,65.6,2247,63.9,59,1.7,0,0.0,1210,34.4,2306,2306,(X),2.6,1734,1734,1013,58.4,1013,58.4,996,57.4,296,296,178,60.1,635,635,508,80.0
27071,10597,10597,6158,58.1,6158,58.1,5737,54.1,421,4.0,0,0.0,4439,41.9,6158,6158,(X),6.8,5321,5321,2892,54.4,2892,54.4,2714,51.0,681,681,582,85.5,1578,1578,1286,81.5
27073,5651,5651,3460,61.2,3460,61.2,3381,59.8,79,1.4,0,0.0,2191,38.8,3460,3460,(X),2.3,2847,2847,1599,56.2,1599,56.2,1577,55.4,373,373,280,75.1,918,918,754,82.1
27075,8935,8935,5099,57.1,5099,57.1,4874,54.5,225,2.5,0,0.0,3836,42.9,5099,5099,(X),4.4,4385,4385,2453,55.9,2453,55.9,2344,53.5,579,579,465,80.3,1136,1136,961,84.6
27077,3161,3161,2129,67.4,2129,67.4,2063,65.3,66,2.1,0,0.0,1032,32.6,2129,2129,(X),3.1,1484,1484,929,62.6,929,62.6,901,60.7,170,170,153,90.0,505,505,476,94.3
27079,22032,22032,15385,69.8,15382,69.8,14840,67.4,542,2.5,3,0.0,6647,30.2,15382,15382,(X),3.5,10959,10959,7163,65.4,7160,65.3,7039,64.2,2139,2139,1631,76.3,4275,4275,3490,81.6
27081,4531,4531,2920,64.4,2918,64.4,2847,62.8,71,1.6,2,0.0,1611,35.6,2918,2918,(X),2.4,2289,2289,1361,59.5,1361,59.5,1335,58.3,427,427,351,82.2,845,845,728,86.2
27083,19940,19940,14252,71.5,14247,71.4,13760,69.0,487,2.4,5,0.0,5688,28.5,14247,14247,(X),3.4,10112,10112,6767,66.9,6767,66.9,6573,65.0,2132,2132,1599,75.0,4155,4155,3569,85.9
27085,28456,28456,19608,68.9,19608,68.9,19095,67.1,513,1.8,0,0.0,8848,31.1,19608,19608,(X),2.6,14334,14334,9138,63.8,9138,63.8,8907,62.1,2500,2500,2120,84.8,5510,5510,4628,84.0
27087,3928,3928,2357,60.0,2357,60.0,2177,55.4,180,4.6,0,0.0,1571,40.0,2357,2357,(X),7.6,2003,2003,1190,59.4,1190,59.4,1089,54.4,443,443,352,79.5,976,976,785,80.4
27089,7486,7486,4939,66.0,4937,65.9,4805,64.2,132,1.8,2,0.0,2547,34.0,4937,4937,(X),2.7,3679,3679,2191,59.6,2191,59.6,2146,58.3,706,706,498,70.5,1381,1381,1149,83.2
27091,16106,16106,10404,64.6,10402,64.6,10037,62.3,365,2.3,2,0.0,5702,35.4,10402,10402,(X),3.5,8161,8161,4833,59.2,4833,59.2,4699,57.6,1434,1434,1110,77.4,2623,2623,2224,84.8
27093,18139,18139,11894,65.6,11880,65.5,11563,63.7,317,1.7,14,0.1,6245,34.4,11880,11880,(X),2.7,8952,8952,5345,59.7,5345,59.7,5244,58.6,1595,1595,1094,68.6,3678,3678,2864,77.9
27095,20163,20163,12860,63.8,12860,63.8,12088,60.0,772,3.8,0,0.0,7303,36.2,12860,12860,(X),6.0,10132,10132,6053,59.7,6053,59.7,5710,56.4,1886,1886,1207,64.0,3921,3921,2998,76.5
27097,26113,26113,17203,65.9,17167,65.7,16432,62.9,735,2.8,36,0.1,8910,34.1,17167,17167,(X),4.3,13001,13001,8177,62.9,8176,62.9,7918,60.9,2410,2410,1686,70.0,5100,5100,4256,83.5
27099,30794,30794,20043,65.1,20043,65.1,19147,62.2,896,2.9,0,0.0,10751,34.9,20043,20043,(X),4.5,15311,15311,9153,59.8,9153,59.8,8746,57.1,3063,3063,2283,74.5,6306,6306,5112,81.1
27101,6776,6776,4368,64.5,4367,64.4,4252,62.8,115,1.7,1,0.0,2408,35.5,4367,4367,(X),2.6,3401,3401,2037,59.9,2037,59.9,2010,59.1,536,536,422,78.7,1156,1156,956,82.7
27103,27216,27216,19797,72.7,19789,72.7,19085,70.1,704,2.6,8,0.0,7419,27.3,19789,19789,(X),3.6,13526,13526,9568,70.7,9568,70.7,9244,68.3,2390,2390,2203,92.2,4864,4864,4173,85.8
27105,16513,16513,11204,67.8,11200,67.8,10632,64.4,568,3.4,4,0.0,5309,32.2,11200,11200,(X),5.1,8041,8041,4957,61.6,4957,61.6,4638,57.7,1888,1888,1286,68.1,3702,3702,2935,79.3
27107,5204,5204,3231,62.1,3225,62.0,3121,60.0,104,2.0,6,0.1,1973,37.9,3225,3225,(X),3.2,2570,2570,1499,58.3,1499,58.3,1447,56.3,420,420,311,74.0,1045,1045,819,78.4
27109,119220,119220,84547,70.9,84505,70.9,81361,68.2,3144,2.6,42,0.0,34673,29.1,84505,84505,(X),3.7,61630,61630,41748,67.7,41748,67.7,40461,65.7,12911,12911,9737,75.4,23770,23770,19707,82.9
27111,46807,46807,29186,62.4,29177,62.3,28193,60.2,984,2.1,9,0.0,17621,37.6,29177,29177,(X),3.4,23318,23318,13459,57.7,13457,57.7,13161,56.4,3987,3987,3018,75.7,8138,8138,6487,79.7
27113,11200,11200,7895,70.5,7895,70.5,7658,68.4,237,2.1,0,0.0,3305,29.5,7895,7895,(X),3.0,5658,5658,3773,66.7,3773,66.7,3686,65.1,1069,1069,860,80.4,2048,2048,1582,77.2
27115,24010,24010,13371,55.7,13365,55.7,12673,52.8,692,2.9,6,0.0,10639,44.3,13365,13365,(X),5.2,11113,11113,6308,56.8,6308,56.8,6013,54.1,1646,1646,1202,73.0,3771,3771,2875,76.2
27117,7134,7134,4513,63.3,4513,63.3,4384,61.5,129,1.8,0,0.0,2621,36.7,4513,4513,(X),2.9,3759,3759,2161,57.5,2161,57.5,2116,56.3,723,723,462,63.9,1435,1435,1074,74.8
27119,24833,24833,16442,66.2,16421,66.1,15861,63.9,560,2.3,21,0.1,8391,33.8,16421,16421,(X),3.4,12320,12320,7720,62.7,7720,62.7,7502,60.9,2477,2477,1900,76.7,4889,4889,4063,83.1
27121,8935,8935,5793,64.8,5793,64.8,5636,63.1,157,1.8,0,0.0,3142,35.2,5793,5793,(X),2.7,4465,4465,2647,59.3,2647,59.3,2611,58.5,730,730,518,71.0,1456,1456,1171,80.4
27123,428170,428170,295672,69.1,295458,69.0,281029,65.6,14429,3.4,214,0.0,132498,30.9,295458,295458,(X),4.9,222208,222208,146758,66.0,146751,66.0,139986,63.0,43875,43875,32432,73.9,78128,78128,59190,75.8
27125,3124,3124,2068,66.2,2068,66.2,2000,64.0,68,2.2,0,0.0,1056,33.8,2068,2068,(X),3.3,1561,1561,993,63.6,993,63.6,978,62.7,324,324,256,79.0,629,629,557,88.6
27127,12045,12045,7682,63.8,7680,63.8,7490,62.2,190,1.6,2,0.0,4363,36.2,7680,7680,(X),2.5,5990,5990,3505,58.5,3505,58.5,3451,57.6,1124,1124,723,64.3,2463,2463,1927,78.2
27129,11699,11699,7551,64.5,7546,64.5,7327,62.6,219,1.9,5,0.0,4148,35.5,7546,7546,(X),2.9,5762,5762,3410,59.2,3410,59.2,3335,57.9,995,995,718,72.2,2225,2225,1667,74.9
27131,52996,52996,35467,66.9,35457,66.9,34128,64.4,1329,2.5,10,0.0,17529,33.1,35457,35457,(X),3.7,25874,25874,16788,64.9,16788,64.9,16251,62.8,4397,4397,2996,68.1,9598,9598,7689,80.1
27133,7376,7376,4892,66.3,4882,66.2,4788,64.9,94,1.3,10,0.1,2484,33.7,4882,4882,(X),1.9,3729,3729,2223,59.6,2221,59.6,2171,58.2,694,694,482,69.5,1593,1593,1295,81.3
27135,12133,12133,8462,69.7,8462,69.7,8239,67.9,223,1.8,0,0.0,3671,30.3,8462,8462,(X),2.6,5881,5881,3912,66.5,3912,66.5,3806,64.7,1115,1115,872,78.2,2454,2454,2045,83.3
27137,166244,166244,103449,62.2,103122,62.0,98063,59.0,5059,3.0,327,0.2,62795,37.8,103122,103122,(X),4.9,83192,83192,49348,59.3,49286,59.2,47371,56.9,12008,12008,8386,69.8,24096,24096,18215,75.6
27139,107507,107507,81445,75.8,81345,75.7,78641,73.1,2704,2.5,100,0.1,26062,24.2,81345,81345,(X),3.3,54147,54147,38228,70.6,38228,70.6,37287,68.9,12003,12003,9264,77.2,27282,27282,22316,81.8
27141,71436,71436,52092,72.9,52074,72.9,50434,70.6,1640,2.3,18,0.0,19344,27.1,52074,52074,(X),3.1,34825,34825,24452,70.2,24452,70.2,24003,68.9,7477,7477,5618,75.1,16950,16950,13542,79.9
27143,11737,11737,8180,69.7,8180,69.7,7949,67.7,231,2.0,0,0.0,3557,30.3,8180,8180,(X),2.8,5802,5802,3697,63.7,3697,63.7,3601,62.1,1046,1046,809,77.3,2293,2293,1947,84.9
27145,124725,124725,89884,72.1,89838,72.0,85674,68.7,4164,3.3,46,0.0,34841,27.9,89838,89838,(X),4.6,62048,62048,43148,69.5,43139,69.5,41338,66.6,11752,11752,9617,81.8,23116,23116,19078,82.5
27147,28324,28324,19706,69.6,19706,69.6,18903,66.7,803,2.8,0,0.0,8618,30.4,19706,19706,(X),4.1,14225,14225,9126,64.2,9126,64.2,8756,61.6,2772,2772,2079,75.0,6162,6162,4819,78.2
27149,7965,7965,5379,67.5,5376,67.5,5254,66.0,122,1.5,3,0.0,2586,32.5,5376,5376,(X),2.3,3992,3992,2613,65.5,2613,65.5,2580,64.6,658,658,500,76.0,1370,1370,1048,76.5
27151,7519,7519,4939,65.7,4939,65.7,4799,63.8,140,1.9,0,0.0,2580,34.3,4939,4939,(X),2.8,3779,3779,2243,59.4,2243,59.4,2179,57.7,661,661,483,73.1,1360,1360,1132,83.2
27153,19236,19236,11479,59.7,11473,59.6,11127,57.8,346,1.8,6,0.0,7757,40.3,11473,11473,(X),3.0,9395,9395,5167,55.0,5167,55.0,5002,53.2,1858,1858,1118,60.2,3715,3715,2405,64.7
27155,2731,2731,1700,62.2,1699,62.2,1650,60.4,49,1.8,1,0.0,1031,37.8,1699,1699,(X),2.9,1373,1373,769,56.0,769,56.0,748,54.5,185,185,151,81.6,477,477,406,85.1
27157,17424,17424,11688,67.1,11679,67.0,11302,64.9,377,2.2,9,0.1,5736,32.9,11679,11679,(X),3.2,8715,8715,5599,64.2,5599,64.2,5435,62.4,1422,1422,1154,81.2,3069,3069,2499,81.4
27159,10606,10606,6352,59.9,6349,59.9,6034,56.9,315,3.0,3,0.0,4254,40.1,6349,6349,(X),5.0,5432,5432,2995,55.1,2995,55.1,2888,53.2,1085,1085,711,65.5,2159,2159,1460,67.6
27161,14974,14974,9629,64.3,9626,64.3,9280,62.0,346,2.3,3,0.0,5345,35.7,9626,9626,(X),3.6,7863,7863,4539,57.7,4539,57.7,4430,56.3,1286,1286,1044,81.2,2826,2826,2356,83.4
27163,197944,197944,140084,70.8,139893,70.7,135605,68.5,4288,2.2,191,0.1,57860,29.2,139893,139893,(X),3.1,100744,100744,67664,67.2,67637,67.1,66005,65.5,18480,18480,14640,79.2,43188,43188,35520,82.2
27165,8670,8670,5743,66.2,5743,66.2,5591,64.5,152,1.8,0,0.0,2927,33.8,5743,5743,(X),2.6,4406,4406,2726,61.9,2726,61.9,2677,60.8,964,964,819,85.0,1597,1597,1378,86.3
27167,5129,5129,3272,63.8,3272,63.8,3226,62.9,46,0.9,0,0.0,1857,36.2,3272,3272,(X),1.4,2549,2549,1443,56.6,1443,56.6,1416,55.6,382,382,323,84.6,900,900,761,84.6
27169,42713,42713,29802,69.8,29733,69.6,28612,67.0,1121,2.6,69,0.2,12911,30.2,29733,29733,(X),3.8,21540,21540,14468,67.2,14468,67.2,14086,65.4,2821,2821,2128,75.4,6029,6029,4964,82.3
27171,99320,99320,73825,74.3,73782,74.3,71417,71.9,2365,2.4,43,0.0,25495,25.7,73782,73782,(X),3.2,49630,49630,34803,70.1,34797,70.1,33769,68.0,11185,11185,8399,75.1,25293,25293,20701,81.8
27173,7859,7859,5067,64.5,5065,64.4,4913,62.5,152,1.9,2,0.0,2792,35.5,5065,5065,(X),3.0,3856,3856,2230,57.8,2230,57.8,2153,55.8,705,705,537,76.2,1449,1449,1085,74.9
28001,25645,25645,11599,45.2,11585,45.2,10424,40.6,1161,4.5,14,0.1,14046,54.8,11585,11585,(X),10.0,12453,12453,5734,46.0,5734,46.0,5331,42.8,2102,2102,1221,58.1,3913,3913,2202,56.3
28003,29360,29360,16280,55.4,16277,55.4,14849,50.6,1428,4.9,3,0.0,13080,44.6,16277,16277,(X),8.8,15257,15257,7566,49.6,7566,49.6,6915,45.3,2455,2455,1747,71.2,5823,5823,3759,64.6
28005,10143,10143,4797,47.3,4797,47.3,4402,43.4,395,3.9,0,0.0,5346,52.7,4797,4797,(X),8.2,5294,5294,2063,39.0,2063,39.0,1862,35.2,748,748,548,73.3,1571,1571,871,55.4
28007,14356,14356,7419,51.7,7412,51.6,6634,46.2,778,5.4,7,0.0,6937,48.3,7412,7412,(X),10.5,7643,7643,3587,46.9,3587,46.9,3134,41.0,1363,1363,964,70.7,3065,3065,2065,67.4
28009,6715,6715,3190,47.5,3190,47.5,2917,43.4,273,4.1,0,0.0,3525,52.5,3190,3190,(X),8.6,3454,3454,1390,40.2,1390,40.2,1267,36.7,304,304,112,36.8,1367,1367,938,68.6
28011,25348,25348,12082,47.7,12061,47.6,10794,42.6,1267,5.0,21,0.1,13266,52.3,12061,12061,(X),10.5,13671,13671,6314,46.2,6314,46.2,5572,40.8,2412,2412,1779,73.8,4818,4818,2907,60.3
28013,11449,11449,5781,50.5,5781,50.5,5365,46.9,416,3.6,0,0.0,5668,49.5,5781,5781,(X),7.2,6098,6098,2714,44.5,2714,44.5,2448,40.1,1029,1029,655,63.7,2051,2051,1322,64.5
28015,8404,8404,3843,45.7,3843,45.7,3466,41.2,377,4.5,0,0.0,4561,54.3,3843,3843,(X),9.8,4154,4154,1649,39.7,1649,39.7,1539,37.0,485,485,226,46.6,1382,1382,794,57.5
28017,13509,13509,7140,52.9,7140,52.9,6729,49.8,411,3.0,0,0.0,6369,47.1,7140,7140,(X),5.8,7079,7079,3401,48.0,3401,48.0,3234,45.7,1451,1451,881,60.7,2661,2661,1949,73.2
28019,6718,6718,3402,50.6,3398,50.6,3097,46.1,301,4.5,4,0.1,3316,49.4,3398,3398,(X),8.9,3426,3426,1561,45.6,1561,45.6,1422,41.5,483,483,306,63.4,1118,1118,681,60.9
28021,7376,7376,3008,40.8,3008,40.8,2538,34.4,470,6.4,0,0.0,4368,59.2,3008,3008,(X),15.6,3949,3949,1570,39.8,1570,39.8,1417,35.9,572,572,325,56.8,1248,1248,516,41.3
28023,12733,12733,6901,54.2,6901,54.2,6337,49.8,564,4.4,0,0.0,5832,45.8,6901,6901,(X),8.2,6817,6817,3401,49.9,3401,49.9,3190,46.8,967,967,739,76.4,2317,2317,1727,74.5
28025,15816,15816,8540,54.0,8511,53.8,7546,47.7,965,6.1,29,0.2,7276,46.0,8511,8511,(X),11.3,8544,8544,4164,48.7,4164,48.7,3690,43.2,1235,1235,873,70.7,3096,3096,2420,78.2
28027,18014,18014,10241,56.9,10227,56.8,8393,46.6,1834,10.2,14,0.1,7773,43.1,10227,10227,(X),17.9,9917,9917,5529,55.8,5515,55.6,4472,45.1,2329,2329,1615,69.3,3843,3843,3151,82.0
28029,22695,22695,11773,51.9,11773,51.9,10523,46.4,1250,5.5,0,0.0,10922,48.1,11773,11773,(X),10.6,11978,11978,5886,49.1,5886,49.1,5344,44.6,1972,1972,1434,72.7,4252,4252,3005,70.7
28031,14837,14837,8096,54.6,8089,54.5,7289,49.1,800,5.4,7,0.0,6741,45.4,8089,8089,(X),9.9,7813,7813,3834,49.1,3834,49.1,3397,43.5,1456,1456,672,46.2,3051,3051,2013,66.0
28033,135892,135892,93220,68.6,92974,68.4,87555,64.4,5419,4.0,246,0.2,42672,31.4,92974,92974,(X),5.8,71202,71202,45806,64.3,45781,64.3,42964,60.3,12190,12190,9339,76.6,31231,31231,24467,78.3
28035,59644,59644,36036,60.4,35925,60.2,32291,54.1,3634,6.1,111,0.2,23608,39.6,35925,35925,(X),10.1,31842,31842,17478,54.9,17460,54.8,15872,49.8,5430,5430,4436,81.7,10948,10948,8104,74.0
28037,6009,6009,2913,48.5,2913,48.5,2727,45.4,186,3.1,0,0.0,3096,51.5,2913,2913,(X),6.4,3146,3146,1393,44.3,1393,44.3,1297,41.2,523,523,266,50.9,1214,1214,889,73.2
28039,18311,18311,9147,50.0,9109,49.7,8266,45.1,843,4.6,38,0.2,9164,50.0,9109,9109,(X),9.3,8906,8906,3887,43.6,3887,43.6,3557,39.9,2101,2101,988,47.0,3957,3957,2503,63.3
28041,11370,11370,4297,37.8,4297,37.8,3903,34.3,394,3.5,0,0.0,7073,62.2,4297,4297,(X),9.2,4263,4263,1945,45.6,1945,45.6,1732,40.6,666,666,476,71.5,1855,1855,984,53.0
28043,16882,16882,8958,53.1,8958,53.1,8341,49.4,617,3.7,0,0.0,7924,46.9,8958,8958,(X),6.9,9002,9002,5103,56.7,5103,56.7,4769,53.0,1510,1510,958,63.4,3283,3283,2474,75.4
28045,37946,37946,20868,55.0,20719,54.6,19029,50.1,1690,4.5,149,0.4,17078,45.0,20719,20719,(X),8.2,19669,19669,9872,50.2,9872,50.2,9046,46.0,2680,2680,1692,63.1,6347,6347,4361,68.7
28047,158617,158617,99210,62.5,93114,58.7,84189,53.1,8925,5.6,6096,3.8,59407,37.5,93114,93114,(X),9.6,81334,81334,46668,57.4,45444,55.9,40849,50.2,16026,16026,9889,61.7,30569,30569,21255,69.5
28049,188930,188930,116848,61.8,116675,61.8,105648,55.9,11027,5.8,173,0.1,72082,38.2,116675,116675,(X),9.5,102880,102880,60868,59.2,60868,59.2,55232,53.7,18059,18059,14016,77.6,37050,37050,29225,78.9
28051,13833,13833,5902,42.7,5902,42.7,4777,34.5,1125,8.1,0,0.0,7931,57.3,5902,5902,(X),19.1,7462,7462,3167,42.4,3167,42.4,2635,35.3,1314,1314,718,54.6,3010,3010,1937,64.4
28053,6532,6532,3429,52.5,3429,52.5,2797,42.8,632,9.7,0,0.0,3103,47.5,3429,3429,(X),18.4,3550,3550,1753,49.4,1753,49.4,1418,39.9,682,682,544,79.8,1385,1385,1130,81.6
28055,1137,1137,415,36.5,415,36.5,358,31.5,57,5.0,0,0.0,722,63.5,415,415,(X),13.7,420,420,202,48.1,202,48.1,171,40.7,119,119,70,58.8,69,69,44,63.8
28057,18949,18949,9923,52.4,9923,52.4,9509,50.2,414,2.2,0,0.0,9026,47.6,9923,9923,(X),4.2,9611,9611,4825,50.2,4825,50.2,4609,48.0,1267,1267,932,73.6,3244,3244,2317,71.4
28059,112363,112363,67563,60.1,66876,59.5,61405,54.6,5471,4.9,687,0.6,44800,39.9,66876,66876,(X),8.2,57755,57755,31696,54.9,31588,54.7,29217,50.6,9416,9416,6318,67.1,22008,22008,16159,73.4
28061,13106,13106,6784,51.8,6779,51.7,6375,48.6,404,3.1,5,0.0,6322,48.2,6779,6779,(X),6.0,6776,6776,3218,47.5,3218,47.5,2923,43.1,1127,1127,732,65.0,2433,2433,1617,66.5
28063,5830,5830,2017,34.6,2017,34.6,1865,32.0,152,2.6,0,0.0,3813,65.4,2017,2017,(X),7.5,3006,3006,1098,36.5,1098,36.5,1053,35.0,431,431,55,12.8,1126,1126,776,68.9
28065,9469,9469,4659,49.2,4659,49.2,4200,44.4,459,4.8,0,0.0,4810,50.8,4659,4659,(X),9.9,5028,5028,2336,46.5,2336,46.5,2129,42.3,600,600,370,61.7,1442,1442,977,67.8
28067,52910,52910,29767,56.3,29765,56.3,27855,52.6,1910,3.6,2,0.0,23143,43.7,29765,29765,(X),6.4,27686,27686,13632,49.2,13632,49.2,12648,45.7,5454,5454,3442,63.1,11137,11137,6913,62.1
28069,8467,8467,3759,44.4,3759,44.4,3499,41.3,260,3.1,0,0.0,4708,55.6,3759,3759,(X),6.9,4197,4197,1781,42.4,1781,42.4,1605,38.2,496,496,426,85.9,1292,1292,985,76.2
28071,44698,44698,26241,58.7,26241,58.7,24456,54.7,1785,4.0,0,0.0,18457,41.3,26241,26241,(X),6.8,23111,23111,12423,53.8,12423,53.8,11493,49.7,3255,3255,2656,81.6,6032,6032,4161,69.0
28073,47528,47528,31033,65.3,30658,64.5,27694,58.3,2964,6.2,375,0.8,16495,34.7,30658,30658,(X),9.7,25089,25089,15100,60.2,15010,59.8,13369,53.3,4807,4807,3489,72.6,9910,9910,6984,70.5
28075,60845,60845,34155,56.1,33351,54.8,31112,51.1,2239,3.7,804,1.3,26690,43.9,33351,33351,(X),6.7,31594,31594,16459,52.1,16320,51.7,15103,47.8,5419,5419,3810,70.3,11607,11607,8316,71.6
28077,9856,9856,5187,52.6,5176,52.5,4716,47.8,460,4.7,11,0.1,4669,47.4,5176,5176,(X),8.9,5112,5112,2358,46.1,2358,46.1,2117,41.4,986,986,715,72.5,1906,1906,1232,64.6
28079,17643,17643,9574,54.3,9574,54.3,8521,48.3,1053,6.0,0,0.0,8069,45.7,9574,9574,(X),11.0,9017,9017,4456,49.4,4456,49.4,4064,45.1,1498,1498,1096,73.2,3535,3535,2518,71.2
28081,65439,65439,40904,62.5,40839,62.4,38207,58.4,2632,4.0,65,0.1,24535,37.5,40839,40839,(X),6.4,34749,34749,19716,56.7,19716,56.7,18241,52.5,6528,6528,4396,67.3,13936,13936,10372,74.4
28083,22450,22450,10366,46.2,10343,46.1,9178,40.9,1165,5.2,23,0.1,12084,53.8,10343,10343,(X),11.3,12401,12401,5500,44.4,5500,44.4,4818,38.9,2897,2897,1687,58.2,4811,4811,2976,61.9
28085,27139,27139,13891,51.2,13875,51.1,12850,47.3,1025,3.8,16,0.1,13248,48.8,13875,13875,(X),7.4,14399,14399,6526,45.3,6526,45.3,6168,42.8,2329,2329,1400,60.1,5392,5392,3684,68.3
28087,46870,46870,27526,58.7,26472,56.5,24037,51.3,2435,5.2,1054,2.2,19344,41.3,26472,26472,(X),9.2,25076,25076,13089,52.2,12928,51.6,11563,46.1,4475,4475,3204,71.6,8763,8763,6483,74.0
28089,80121,80121,54889,68.5,54756,68.3,52097,65.0,2659,3.3,133,0.2,25232,31.5,54756,54756,(X),4.9,42428,42428,26832,63.2,26823,63.2,25318,59.7,8255,8255,5945,72.0,16933,16933,13516,79.8
28091,19931,19931,9507,47.7,9450,47.4,8786,44.1,664,3.3,57,0.3,10424,52.3,9450,9450,(X),7.0,10266,10266,4365,42.5,4365,42.5,4087,39.8,1784,1784,1136,63.7,3777,3777,2009,53.2
28093,28759,28759,15270,53.1,15249,53.0,14243,49.5,1006,3.5,21,0.1,13489,46.9,15249,15249,(X),6.6,14462,14462,7276,50.3,7264,50.2,6860,47.4,2620,2620,1606,61.3,4486,4486,2894,64.5
28095,28460,28460,15355,54.0,15355,54.0,14371,50.5,984,3.5,0,0.0,13105,46.0,15355,15355,(X),6.4,15082,15082,7323,48.6,7323,48.6,6771,44.9,2539,2539,1804,71.1,5283,5283,3879,73.4
28097,8098,8098,4334,53.5,4331,53.5,3886,48.0,445,5.5,3,0.0,3764,46.5,4331,4331,(X),10.3,4332,4332,2079,48.0,2079,48.0,1796,41.5,748,748,515,68.9,1429,1429,1003,70.2
28099,22181,22181,13203,59.5,13154,59.3,12025,54.2,1129,5.1,49,0.2,8978,40.5,13154,13154,(X),8.6,11828,11828,6823,57.7,6815,57.6,6316,53.4,2114,2114,1533,72.5,5315,5315,4024,75.7
28101,16691,16691,8888,53.3,8862,53.1,8250,49.4,612,3.7,26,0.2,7803,46.7,8862,8862,(X),6.9,8848,8848,4398,49.7,4396,49.7,4071,46.0,1551,1551,919,59.3,3525,3525,2449,69.5
28103,8447,8447,4500,53.3,4500,53.3,4046,47.9,454,5.4,0,0.0,3947,46.7,4500,4500,(X),10.1,4513,4513,2220,49.2,2220,49.2,1882,41.7,824,824,454,55.1,1744,1744,1216,69.7
28105,41666,41666,23145,55.5,23131,55.5,20852,50.0,2279,5.5,14,0.0,18521,44.5,23131,23131,(X),9.9,20897,20897,10822,51.8,10808,51.7,9820,47.0,3085,3085,2257,73.2,5230,5230,3888,74.3
28107,26448,26448,13714,51.9,13685,51.7,12702,48.0,983,3.7,29,0.1,12734,48.1,13685,13685,(X),7.2,13785,13785,6899,50.0,6899,50.0,6449,46.8,2850,2850,2250,78.9,5323,5323,4000,75.1
28109,44172,44172,23657,53.6,23587,53.4,21599,48.9,1988,4.5,70,0.2,20515,46.4,23587,23587,(X),8.4,22610,22610,10688,47.3,10688,47.3,9828,43.5,3484,3484,2060,59.1,7899,7899,5389,68.2
28111,9508,9508,4951,52.1,4928,51.8,4591,48.3,337,3.5,23,0.2,4557,47.9,4928,4928,(X),6.8,4998,4998,2285,45.7,2285,45.7,2121,42.4,802,802,557,69.5,1726,1726,1112,64.4
28113,30553,30553,15033,49.2,15033,49.2,13927,45.6,1106,3.6,0,0.0,15520,50.8,15033,15033,(X),7.4,16345,16345,7334,44.9,7334,44.9,6830,41.8,3038,3038,2196,72.3,6512,6512,4508,69.2
28115,23783,23783,14205,59.7,14203,59.7,13183,55.4,1020,4.3,2,0.0,9578,40.3,14203,14203,(X),7.2,12183,12183,6699,55.0,6697,55.0,6313,51.8,2502,2502,1919,76.7,5482,5482,4414,80.5
28117,20195,20195,10414,51.6,10414,51.6,9661,47.8,753,3.7,0,0.0,9781,48.4,10414,10414,(X),7.2,10572,10572,4831,45.7,4831,45.7,4500,42.6,1773,1773,1108,62.5,3219,3219,2223,69.1
28119,5828,5828,3074,52.7,3074,52.7,2280,39.1,794,13.6,0,0.0,2754,47.3,3074,3074,(X),25.8,3162,3162,1522,48.1,1522,48.1,1101,34.8,574,574,428,74.6,977,977,773,79.1
28121,119621,119621,76882,64.3,76671,64.1,73418,61.4,3253,2.7,211,0.2,42739,35.7,76671,76671,(X),4.2,62687,62687,37285,59.5,37228,59.4,35569,56.7,10904,10904,7676,70.4,23279,23279,17453,75.0
28123,21740,21740,12358,56.8,12338,56.8,11360,52.3,978,4.5,20,0.1,9382,43.2,12338,12338,(X),7.9,11276,11276,5743,50.9,5743,50.9,5279,46.8,2434,2434,1644,67.5,4510,4510,3244,71.9
28125,3542,3542,1784,50.4,1784,50.4,1489,42.0,295,8.3,0,0.0,1758,49.6,1784,1784,(X),16.5,1960,1960,977,49.8,977,49.8,866,44.2,294,294,257,87.4,709,709,539,76.0
28127,21331,21331,11617,54.5,11597,54.4,10649,49.9,948,4.4,20,0.1,9714,45.5,11597,11597,(X),8.2,11184,11184,5576,49.9,5576,49.9,4956,44.3,1740,1740,1231,70.7,4095,4095,3337,81.5
28129,12593,12593,6795,54.0,6795,54.0,6563,52.1,232,1.8,0,0.0,5798,46.0,6795,6795,(X),3.4,6567,6567,3028,46.1,3028,46.1,2947,44.9,1136,1136,681,59.9,2606,2606,1767,67.8
28131,14884,14884,8314,55.9,8275,55.6,7874,52.9,401,2.7,39,0.3,6570,44.1,8275,8275,(X),4.8,7388,7388,4118,55.7,4093,55.4,3823,51.7,1167,1167,826,70.8,2648,2648,1726,65.2
28133,21135,21135,9737,46.1,9735,46.1,8173,38.7,1562,7.4,2,0.0,11398,53.9,9735,9735,(X),16.0,9908,9908,5195,52.4,5195,52.4,4444,44.9,1691,1691,1208,71.4,3756,3756,2825,75.2
28135,11853,11853,4467,37.7,4467,37.7,3833,32.3,634,5.3,0,0.0,7386,62.3,4467,4467,(X),14.2,5031,5031,2427,48.2,2427,48.2,1934,38.4,827,827,600,72.6,1755,1755,1175,67.0
28137,22689,22689,12999,57.3,12999,57.3,12012,52.9,987,4.4,0,0.0,9690,42.7,12999,12999,(X),7.6,11832,11832,6547,55.3,6547,55.3,5866,49.6,1955,1955,1478,75.6,4218,4218,3022,71.6
28139,17062,17062,9598,56.3,9596,56.2,8853,51.9,743,4.4,2,0.0,7464,43.7,9596,9596,(X),7.7,8929,8929,4658,52.2,4658,52.2,4194,47.0,1698,1698,1160,68.3,3451,3451,2462,71.3
28141,15700,15700,8634,55.0,8634,55.0,7801,49.7,833,5.3,0,0.0,7066,45.0,8634,8634,(X),9.6,8150,8150,3974,48.8,3974,48.8,3528,43.3,1259,1259,728,57.8,2862,2862,2137,74.7
28143,7522,7522,4645,61.8,4645,61.8,4156,55.3,489,6.5,0,0.0,2877,38.2,4645,4645,(X),10.5,4080,4080,2398,58.8,2398,58.8,2105,51.6,951,951,813,85.5,1856,1856,1634,88.0
28145,22015,22015,12941,58.8,12941,58.8,12120,55.1,821,3.7,0,0.0,9074,41.2,12941,12941,(X),6.3,11312,11312,6240,55.2,6240,55.2,5794,51.2,1951,1951,1522,78.0,4920,4920,3467,70.5
28147,11518,11518,5820,50.5,5820,50.5,5459,47.4,361,3.1,0,0.0,5698,49.5,5820,5820,(X),6.2,6064,6064,2670,44.0,2670,44.0,2497,41.2,945,945,537,56.8,2217,2217,1479,66.7
28149,36835,36835,20943,56.9,20877,56.7,19368,52.6,1509,4.1,66,0.2,15892,43.1,20877,20877,(X),7.2,19589,19589,10406,53.1,10398,53.1,9638,49.2,3333,3333,2337,70.1,7387,7387,5395,73.0
28151,36109,36109,20200,55.9,20174,55.9,17133,47.4,3041,8.4,26,0.1,15909,44.1,20174,20174,(X),15.1,19649,19649,10234,52.1,10232,52.1,8958,45.6,3855,3855,2692,69.8,7400,7400,5508,74.4
28153,16000,16000,9017,56.4,9017,56.4,8174,51.1,843,5.3,0,0.0,6983,43.6,9017,9017,(X),9.3,8341,8341,4459,53.5,4459,53.5,3945,47.3,1541,1541,907,58.9,3227,3227,2107,65.3
28155,7700,7700,3940,51.2,3940,51.2,3740,48.6,200,2.6,0,0.0,3760,48.8,3940,3940,(X),5.1,4008,4008,1872,46.7,1872,46.7,1746,43.6,672,672,360,53.6,1616,1616,936,57.9
28157,7313,7313,2771,37.9,2771,37.9,2468,33.7,303,4.1,0,0.0,4542,62.1,2771,2771,(X),10.9,3389,3389,1508,44.5,1508,44.5,1430,42.2,551,551,494,89.7,994,994,631,63.5
28159,14576,14576,7825,53.7,7825,53.7,7181,49.3,644,4.4,0,0.0,6751,46.3,7825,7825,(X),8.2,7562,7562,3802,50.3,3802,50.3,3459,45.7,1083,1083,668,61.7,2819,2819,2121,75.2
28161,9945,9945,5695,57.3,5695,57.3,5442,54.7,253,2.5,0,0.0,4250,42.7,5695,5695,(X),4.4,5235,5235,2864,54.7,2864,54.7,2751,52.6,876,876,600,68.5,1691,1691,1258,74.4
28163,21984,21984,9535,43.4,9535,43.4,8109,36.9,1426,6.5,0,0.0,12449,56.6,9535,9535,(X),15.0,9603,9603,5004,52.1,5004,52.1,4136,43.1,1937,1937,1068,55.1,4079,4079,2837,69.6
29001,21380,21380,11611,54.3,11578,54.2,10827,50.6,751,3.5,33,0.2,9769,45.7,11578,11578,(X),6.5,11238,11238,5751,51.2,5745,51.1,5471,48.7,1432,1432,824,57.5,2852,2852,2412,84.6
29003,13991,13991,8780,62.8,8752,62.6,8476,60.6,276,2.0,28,0.2,5211,37.2,8752,8752,(X),3.2,7042,7042,4041,57.4,4033,57.3,3955,56.2,1055,1055,786,74.5,2633,2633,1959,74.4
29005,4366,4366,2739,62.7,2739,62.7,2649,60.7,90,2.1,0,0.0,1627,37.3,2739,2739,(X),3.3,2216,2216,1272,57.4,1272,57.4,1222,55.1,301,301,203,67.4,655,655,574,87.6
29007,20455,20455,11578,56.6,11578,56.6,10751,52.6,827,4.0,0,0.0,8877,43.4,11578,11578,(X),7.1,11430,11430,5495,48.1,5495,48.1,5050,44.2,1715,1715,1118,65.2,3484,3484,2943,84.5
29009,28596,28596,15311,53.5,15311,53.5,14590,51.0,721,2.5,0,0.0,13285,46.5,15311,15311,(X),4.7,14461,14461,6782,46.9,6782,46.9,6301,43.6,2233,2233,1166,52.2,5132,5132,3223,62.8
29011,9426,9426,5513,58.5,5513,58.5,5195,55.1,318,3.4,0,0.0,3913,41.5,5513,5513,(X),5.8,4833,4833,2374,49.1,2374,49.1,2325,48.1,683,683,364,53.3,1874,1874,1321,70.5
29013,12927,12927,7965,61.6,7962,61.6,7612,58.9,350,2.7,3,0.0,4962,38.4,7962,7962,(X),4.4,6692,6692,3850,57.5,3850,57.5,3689,55.1,1157,1157,930,80.4,2485,2485,1843,74.2
29015,16151,16151,7162,44.3,7162,44.3,6573,40.7,589,3.6,0,0.0,8989,55.7,7162,7162,(X),8.2,8206,8206,3452,42.1,3452,42.1,3252,39.6,939,939,629,67.0,2129,2129,1243,58.4
29017,9956,9956,5295,53.2,5295,53.2,5059,50.8,236,2.4,0,0.0,4661,46.8,5295,5295,(X),4.5,5002,5002,2463,49.2,2463,49.2,2378,47.5,694,694,398,57.3,1950,1950,1261,64.7
29019,144697,144697,97729,67.5,97537,67.4,93375,64.5,4162,2.9,192,0.1,46968,32.5,97537,97537,(X),4.3,75379,75379,49327,65.4,49304,65.4,47584,63.1,12047,12047,8764,72.7,22003,22003,17844,81.1
29021,70848,70848,44273,62.5,44179,62.4,41913,59.2,2266,3.2,94,0.1,26575,37.5,44179,44179,(X),5.1,35361,35361,20895,59.1,20860,59.0,20109,56.9,6562,6562,4592,70.0,12539,12539,9089,72.5
29023,33998,33998,18828,55.4,18812,55.3,17067,50.2,1745,5.1,16,0.0,15170,44.6,18812,18812,(X),9.3,17558,17558,8961,51.0,8945,50.9,8405,47.9,3081,3081,2133,69.2,5985,5985,4183,69.9
29025,7123,7123,3979,55.9,3974,55.8,3874,54.4,100,1.4,5,0.1,3144,44.1,3974,3974,(X),2.5,3571,3571,1862,52.1,1862,52.1,1810,50.7,583,583,342,58.7,1359,1359,933,68.7
29027,36587,36587,21151,57.8,21126,57.7,20425,55.8,701,1.9,25,0.1,15436,42.2,21126,21126,(X),3.3,17934,17934,10443,58.2,10443,58.2,10167,56.7,2766,2766,1914,69.2,5903,5903,4824,81.7
29029,38091,38091,19528,51.3,19493,51.2,18231,47.9,1262,3.3,35,0.1,18563,48.7,19493,19493,(X),6.5,19349,19349,9408,48.6,9408,48.6,8879,45.9,2167,2167,1119,51.6,4755,4755,3323,69.9
29031,63224,63224,39806,63.0,39668,62.7,37627,59.5,2041,3.2,138,0.2,23418,37.0,39668,39668,(X),5.1,32984,32984,19641,59.5,19545,59.3,18780,56.9,5264,5264,3507,66.6,10695,10695,8055,75.3
29033,7045,7045,4045,57.4,4045,57.4,3699,52.5,346,4.9,0,0.0,3000,42.6,4045,4045,(X),8.6,3677,3677,1920,52.2,1920,52.2,1772,48.2,709,709,518,73.1,1192,1192,859,72.1
29035,4855,4855,2641,54.4,2619,53.9,2433,50.1,186,3.8,22,0.5,2214,45.6,2619,2619,(X),7.1,2501,2501,1269,50.7,1269,50.7,1159,46.3,405,405,319,78.8,1082,1082,824,76.2
29037,80167,80167,52962,66.1,52942,66.0,50661,63.2,2281,2.8,20,0.0,27205,33.9,52942,52942,(X),4.3,41449,41449,24965,60.2,24956,60.2,23757,57.3,7387,7387,4639,62.8,16817,16817,12631,75.1
29039,10995,10995,5763,52.4,5763,52.4,5243,47.7,520,4.7,0,0.0,5232,47.6,5763,5763,(X),9.0,5566,5566,2680,48.1,2680,48.1,2511,45.1,1013,1013,730,72.1,2078,2078,1305,62.8
29041,6031,6031,3264,54.1,3264,54.1,3158,52.4,106,1.8,0,0.0,2767,45.9,3264,3264,(X),3.2,3076,3076,1557,50.6,1557,50.6,1504,48.9,554,554,453,81.8,1127,1127,886,78.6
29043,65172,65172,41810,64.2,41792,64.1,40014,61.4,1778,2.7,18,0.0,23362,35.8,41792,41792,(X),4.3,33986,33986,19874,58.5,19874,58.5,19110,56.2,6178,6178,4113,66.6,14411,14411,9975,69.2
29045,5394,5394,3408,63.2,3390,62.8,3267,60.6,123,2.3,18,0.3,1986,36.8,3390,3390,(X),3.6,2655,2655,1533,57.7,1515,57.1,1472,55.4,500,500,365,73.0,951,951,622,65.4
29047,187200,187200,130998,70.0,130797,69.9,125517,67.0,5280,2.8,201,0.1,56202,30.0,130797,130797,(X),4.0,96299,96299,62927,65.3,62927,65.3,60422,62.7,17908,17908,12983,72.5,37696,37696,29778,79.0
29049,16331,16331,9960,61.0,9918,60.7,9424,57.7,494,3.0,42,0.3,6371,39.0,9918,9918,(X),5.0,8287,8287,4725,57.0,4722,57.0,4420,53.3,1152,1152,723,62.8,3266,3266,2481,76.0
29051,61224,61224,39125,63.9,39055,63.8,37467,61.2,1588,2.6,70,0.1,22099,36.1,39055,39055,(X),4.1,30322,30322,18920,62.4,18905,62.3,18191,60.0,5446,5446,4320,79.3,11119,11119,9611,86.4
29053,14222,14222,8061,56.7,8047,56.6,7669,53.9,378,2.7,14,0.1,6161,43.3,8047,8047,(X),4.7,6740,6740,4023,59.7,4023,59.7,3891,57.7,1151,1151,862,74.9,2534,2534,2003,79.0
29055,19262,19262,10501,54.5,10501,54.5,9443,49.0,1058,5.5,0,0.0,8761,45.5,10501,10501,(X),10.1,9842,9842,5058,51.4,5058,51.4,4359,44.3,1675,1675,982,58.6,3548,3548,2207,62.2
29057,6269,6269,3397,54.2,3397,54.2,3106,49.5,291,4.6,0,0.0,2872,45.8,3397,3397,(X),8.6,3132,3132,1494,47.7,1494,47.7,1379,44.0,394,394,243,61.7,1024,1024,677,66.1
29059,12988,12988,6558,50.5,6532,50.3,6197,47.7,335,2.6,26,0.2,6430,49.5,6532,6532,(X),5.1,6533,6533,2954,45.2,2954,45.2,2840,43.5,1055,1055,516,48.9,2765,2765,1569,56.7
29061,6425,6425,3625,56.4,3625,56.4,3510,54.6,115,1.8,0,0.0,2800,43.6,3625,3625,(X),3.2,3212,3212,1658,51.6,1658,51.6,1616,50.3,588,588,288,49.0,1398,1398,831,59.4
29063,10786,10786,4409,40.9,4402,40.8,4276,39.6,126,1.2,7,0.1,6377,59.1,4402,4402,(X),2.9,3806,3806,1956,51.4,1956,51.4,1894,49.8,597,597,325,54.4,1442,1442,995,69.0
29065,12363,12363,6655,53.8,6655,53.8,6230,50.4,425,3.4,0,0.0,5708,46.2,6655,6655,(X),6.4,6271,6271,3037,48.4,3037,48.4,2898,46.2,1075,1075,718,66.8,2189,2189,1564,71.4
29067,10828,10828,5118,47.3,5118,47.3,4802,44.3,316,2.9,0,0.0,5710,52.7,5118,5118,(X),6.2,5456,5456,2161,39.6,2161,39.6,2118,38.8,844,844,596,70.6,1858,1858,1350,72.7
29069,23485,23485,12287,52.3,12276,52.3,11346,48.3,930,4.0,11,0.0,11198,47.7,12276,12276,(X),7.6,12458,12458,5859,47.0,5859,47.0,5415,43.5,2382,2382,1534,64.4,4781,4781,2887,60.4
29071,81828,81828,52576,64.3,52534,64.2,50288,61.5,2246,2.7,42,0.1,29252,35.7,52534,52534,(X),4.3,41365,41365,24376,58.9,24376,58.9,23415,56.6,7282,7282,5579,76.6,15267,15267,11629,76.2
29073,11960,11960,7063,59.1,7063,59.1,6891,57.6,172,1.4,0,0.0,4897,40.9,7063,7063,(X),2.4,6114,6114,3314,54.2,3314,54.2,3253,53.2,922,922,755,81.9,2004,2004,1489,74.3
29075,5196,5196,3142,60.5,3138,60.4,3026,58.2,112,2.2,4,0.1,2054,39.5,3138,3138,(X),3.6,2699,2699,1527,56.6,1527,56.6,1487,55.1,551,551,352,63.9,1018,1018,698,68.6
29077,234490,234490,144675,61.7,144534,61.6,138126,58.9,6408,2.7,141,0.1,89815,38.3,144534,144534,(X),4.4,121888,121888,69348,56.9,69348,56.9,66578,54.6,19523,19523,12396,63.5,37069,37069,26253,70.8
29079,7939,7939,4758,59.9,4758,59.9,4590,57.8,168,2.1,0,0.0,3181,40.1,4758,4758,(X),3.5,4082,4082,2136,52.3,2136,52.3,2069,50.7,835,835,520,62.3,1395,1395,1001,71.8
29081,6699,6699,3948,58.9,3947,58.9,3769,56.3,178,2.7,1,0.0,2751,41.1,3947,3947,(X),4.5,3399,3399,1919,56.5,1919,56.5,1834,54.0,683,683,475,69.5,1327,1327,1078,81.2
29083,17505,17505,9473,54.1,9440,53.9,8831,50.4,609,3.5,33,0.2,8032,45.9,9440,9440,(X),6.5,8950,8950,4408,49.3,4408,49.3,4181,46.7,1318,1318,758,57.5,3004,3004,2297,76.5
29085,8002,8002,3487,43.6,3486,43.6,3258,40.7,228,2.8,1,0.0,4515,56.4,3486,3486,(X),6.5,4106,4106,1596,38.9,1596,38.9,1501,36.6,489,489,400,81.8,1022,1022,570,55.8
29087,3638,3638,2155,59.2,2148,59.0,2063,56.7,85,2.3,7,0.2,1483,40.8,2148,2148,(X),4.0,1853,1853,984,53.1,984,53.1,936,50.5,298,298,163,54.7,566,566,457,80.7
29089,8086,8086,4933,61.0,4932,61.0,4727,58.5,205,2.5,1,0.0,3153,39.0,4932,4932,(X),4.2,4078,4078,2422,59.4,2422,59.4,2346,57.5,721,721,571,79.2,1441,1441,1193,82.8
29091,31719,31719,17410,54.9,17406,54.9,16617,52.4,789,2.5,4,0.0,14309,45.1,17406,17406,(X),4.5,16444,16444,8260,50.2,8260,50.2,7980,48.5,2727,2727,1576,57.8,6022,6022,4002,66.5
29093,8347,8347,4186,50.1,4186,50.1,3884,46.5,302,3.6,0,0.0,4161,49.9,4186,4186,(X),7.2,4304,4304,1940,45.1,1940,45.1,1824,42.4,557,557,282,50.6,1318,1318,769,58.3
29095,544741,544741,362349,66.5,362029,66.5,343721,63.1,18308,3.4,320,0.1,182392,33.5,362029,362029,(X),5.1,285172,285172,178062,62.4,178014,62.4,168871,59.2,52786,52786,37266,70.6,103695,103695,78473,75.7
29097,92526,92526,59959,64.8,59930,64.8,56742,61.3,3188,3.4,29,0.0,32567,35.2,59930,59930,(X),5.3,47832,47832,28557,59.7,28557,59.7,27229,56.9,9450,9450,6323,66.9,18272,18272,12927,70.7
29099,176587,176587,117120,66.3,117062,66.3,110438,62.5,6624,3.8,58,0.0,59467,33.7,117062,117062,(X),5.7,89723,89723,55025,61.3,55025,61.3,52519,58.5,15661,15661,11590,74.0,34540,34540,26578,76.9
29101,43250,43250,28639,66.2,25580,59.1,24266,56.1,1314,3.0,3059,7.1,14611,33.8,25580,25580,(X),5.1,20989,20989,13055,62.2,12681,60.4,12131,57.8,3940,3940,2490,63.2,7062,7062,5405,76.5
29103,3136,3136,1688,53.8,1688,53.8,1575,50.2,113,3.6,0,0.0,1448,46.2,1688,1688,(X),6.7,1577,1577,706,44.8,706,44.8,670,42.5,282,282,233,82.6,619,619,426,68.8
29105,27657,27657,16191,58.5,16115,58.3,15006,54.3,1109,4.0,76,0.3,11466,41.5,16115,16115,(X),6.9,14120,14120,7294,51.7,7294,51.7,6604,46.8,2561,2561,1668,65.1,5641,5641,3666,65.0
29107,26081,26081,16025,61.4,16024,61.4,15313,58.7,711,2.7,1,0.0,10056,38.6,16024,16024,(X),4.4,13427,13427,7445,55.4,7445,55.4,7232,53.9,2271,2271,1268,55.8,4854,4854,3398,70.0
29109,29519,29519,17947,60.8,17947,60.8,16841,57.1,1106,3.7,0,0.0,11572,39.2,17947,17947,(X),6.2,15005,15005,8317,55.4,8317,55.4,7944,52.9,2887,2887,1951,67.6,6287,6287,4275,68.0
29111,8008,8008,4760,59.4,4760,59.4,4637,57.9,123,1.5,0,0.0,3248,40.6,4760,4760,(X),2.6,4018,4018,2247,55.9,2247,55.9,2188,54.5,598,598,352,58.9,1513,1513,1140,75.3
29113,43049,43049,27508,63.9,27492,63.9,26349,61.2,1143,2.7,16,0.0,15541,36.1,27492,27492,(X),4.2,21821,21821,12961,59.4,12961,59.4,12367,56.7,4279,4279,2983,69.7,8979,8979,6575,73.2
29115,9580,9580,5653,59.0,5653,59.0,5496,57.4,157,1.6,0,0.0,3927,41.0,5653,5653,(X),2.8,5019,5019,2716,54.1,2716,54.1,2679,53.4,800,800,705,88.1,1940,1940,1519,78.3
29117,12162,12162,6771,55.7,6759,55.6,6605,54.3,154,1.3,12,0.1,5391,44.3,6759,6759,(X),2.3,6848,6848,3211,46.9,3211,46.9,3152,46.0,984,984,633,64.3,1966,1966,1481,75.3
29119,17603,17603,9860,56.0,9842,55.9,9408,53.4,434,2.5,18,0.1,7743,44.0,9842,9842,(X),4.4,8742,8742,4389,50.2,4389,50.2,4217,48.2,1758,1758,730,41.5,3684,3684,2214,60.1
29121,12067,12067,6690,55.4,6683,55.4,6363,52.7,320,2.7,7,0.1,5377,44.6,6683,6683,(X),4.8,6108,6108,3271,53.6,3266,53.5,3096,50.7,1120,1120,670,59.8,2398,2398,1822,76.0
29123,9705,9705,5274,54.3,5252,54.1,5035,51.9,217,2.2,22,0.2,4431,45.7,5252,5252,(X),4.1,4937,4937,2342,47.4,2342,47.4,2227,45.1,872,872,349,40.0,1583,1583,991,62.6
29125,7263,7263,4013,55.3,3951,54.4,3677,50.6,274,3.8,62,0.9,3250,44.7,3951,3951,(X),6.9,3575,3575,1878,52.5,1878,52.5,1755,49.1,510,510,283,55.5,1221,1221,810,66.3
29127,22508,22508,13802,61.3,13802,61.3,13090,58.2,712,3.2,0,0.0,8706,38.7,13802,13802,(X),5.2,11727,11727,6871,58.6,6871,58.6,6400,54.6,2061,2061,1697,82.3,4451,4451,3390,76.2
29129,2828,2828,1705,60.3,1703,60.2,1660,58.7,43,1.5,2,0.1,1123,39.7,1703,1703,(X),2.5,1419,1419,777,54.8,777,54.8,759,53.5,280,280,199,71.1,583,583,389,66.7
29131,19795,19795,11514,58.2,11497,58.1,10823,54.7,674,3.4,17,0.1,8281,41.8,11497,11497,(X),5.9,10175,10175,5469,53.7,5469,53.7,5300,52.1,1723,1723,1385,80.4,3826,3826,3212,84.0
29133,11060,11060,5028,45.5,5028,45.5,4654,42.1,374,3.4,0,0.0,6032,54.5,5028,5028,(X),7.4,4992,4992,2324,46.6,2324,46.6,2168,43.4,679,679,462,68.0,2002,2002,1307,65.3
29135,12372,12372,7004,56.6,6992,56.5,6627,53.6,365,3.0,12,0.1,5368,43.4,6992,6992,(X),5.2,5725,5725,3420,59.7,3413,59.6,3283,57.3,1247,1247,758,60.8,2646,2646,2051,77.5
29137,6956,6956,4044,58.1,4036,58.0,3879,55.8,157,2.3,8,0.1,2912,41.9,4036,4036,(X),3.9,3494,3494,1872,53.6,1872,53.6,1830,52.4,522,522,378,72.4,1338,1338,974,72.8
29139,9205,9205,5240,56.9,5240,56.9,5031,54.7,209,2.3,0,0.0,3965,43.1,5240,5240,(X),4.0,4667,4667,2341,50.2,2341,50.2,2241,48.0,835,835,587,70.3,1635,1635,1272,77.8
29141,16053,16053,7680,47.8,7660,47.7,7368,45.9,292,1.8,20,0.1,8373,52.2,7660,7660,(X),3.8,8223,8223,3554,43.2,3554,43.2,3400,41.3,1293,1293,532,41.1,3028,3028,1649,54.5
29143,14109,14109,7251,51.4,7251,51.4,6622,46.9,629,4.5,0,0.0,6858,48.6,7251,7251,(X),8.7,7449,7449,3392,45.5,3392,45.5,3146,42.2,1244,1244,828,66.6,2485,2485,1759,70.8
29145,45849,45849,27985,61.0,27955,61.0,26841,58.5,1114,2.4,30,0.1,17864,39.0,27955,27955,(X),4.0,23392,23392,12838,54.9,12838,54.9,12293,52.6,4155,4155,2686,64.6,9333,9333,6298,67.5
29147,19303,19303,11515,59.7,11505,59.6,11062,57.3,443,2.3,10,0.1,7788,40.3,11505,11505,(X),3.9,9702,9702,5701,58.8,5701,58.8,5566,57.4,1225,1225,804,65.6,2209,2209,1622,73.4
29149,8598,8598,4220,49.1,4220,49.1,4095,47.6,125,1.5,0,0.0,4378,50.9,4220,4220,(X),3.0,4356,4356,1943,44.6,1943,44.6,1911,43.9,727,727,428,58.9,1307,1307,799,61.1
29151,10800,10800,7165,66.3,7165,66.3,6991,64.7,174,1.6,0,0.0,3635,33.7,7165,7165,(X),2.4,5173,5173,3370,65.1,3370,65.1,3303,63.9,792,792,646,81.6,2244,2244,1934,86.2
29153,7663,7663,3380,44.1,3380,44.1,3139,41.0,241,3.1,0,0.0,4283,55.9,3380,3380,(X),7.1,3892,3892,1539,39.5,1539,39.5,1450,37.3,398,398,195,49.0,1143,1143,628,54.9
29155,13063,13063,6763,51.8,6763,51.8,6101,46.7,662,5.1,0,0.0,6300,48.2,6763,6763,(X),9.8,7061,7061,3396,48.1,3396,48.1,3070,43.5,1254,1254,745,59.4,2673,2673,1667,62.4
29157,15100,15100,9586,63.5,9540,63.2,9181,60.8,359,2.4,46,0.3,5514,36.5,9540,9540,(X),3.8,7715,7715,4493,58.2,4487,58.2,4360,56.5,1340,1340,919,68.6,2985,2985,2065,69.2
29159,33088,33088,19882,60.1,19782,59.8,18609,56.2,1173,3.5,100,0.3,13206,39.9,19782,19782,(X),5.9,17048,17048,9253,54.3,9253,54.3,8592,50.4,3189,3189,2037,63.9,6601,6601,4408,66.8
29161,36548,36548,20328,55.6,20252,55.4,19026,52.1,1226,3.4,76,0.2,16220,44.4,20252,20252,(X),6.1,17286,17286,9156,53.0,9138,52.9,8681,50.2,3037,3037,1812,59.7,5695,5695,4243,74.5
29163,14966,14966,7897,52.8,7897,52.8,7540,50.4,357,2.4,0,0.0,7069,47.2,7897,7897,(X),4.5,6634,6634,3736,56.3,3736,56.3,3601,54.3,1344,1344,957,71.2,2379,2379,1694,71.2
29165,77929,77929,55074,70.7,54731,70.2,52703,67.6,2028,2.6,343,0.4,22855,29.3,54731,54731,(X),3.7,39739,39739,26166,65.8,26053,65.6,25298,63.7,7254,7254,4948,68.2,15555,15555,12446,80.0
29167,25106,25106,14881,59.3,14858,59.2,14135,56.3,723,2.9,23,0.1,10225,40.7,14858,14858,(X),4.9,13015,13015,7329,56.3,7329,56.3,6951,53.4,2115,2115,1301,61.5,4618,4618,3243,70.2
29169,42298,42298,29680,70.2,17940,42.4,16357,38.7,1583,3.7,11740,27.8,12618,29.8,17940,17940,(X),8.8,17811,17811,10570,59.3,8096,45.5,7485,42.0,3954,3954,1932,48.9,6687,6687,4115,61.5
29171,3846,3846,2083,54.2,2083,54.2,1981,51.5,102,2.7,0,0.0,1763,45.8,2083,2083,(X),4.9,1956,1956,943,48.2,943,48.2,908,46.4,353,353,171,48.4,717,717,385,53.7
29173,8274,8274,5245,63.4,5240,63.3,5006,60.5,234,2.8,5,0.1,3029,36.6,5240,5240,(X),4.5,4102,4102,2423,59.1,2423,59.1,2361,57.6,551,551,406,73.7,1460,1460,1221,83.6
29175,20086,20086,10895,54.2,10887,54.2,10263,51.1,624,3.1,8,0.0,9191,45.8,10887,10887,(X),5.7,9560,9560,5460,57.1,5452,57.0,5234,54.7,1848,1848,1484,80.3,3334,3334,2536,76.1
29177,18278,18278,11314,61.9,11308,61.9,10745,58.8,563,3.1,6,0.0,6964,38.1,11308,11308,(X),5.0,9265,9265,5135,55.4,5135,55.4,4943,53.4,1483,1483,1005,67.8,3513,3513,2610,74.3
29179,5237,5237,2660,50.8,2660,50.8,2483,47.4,177,3.4,0,0.0,2577,49.2,2660,2660,(X),6.7,2617,2617,1243,47.5,1243,47.5,1161,44.4,274,274,129,47.1,847,847,497,58.7
29181,10861,10861,5507,50.7,5503,50.7,5129,47.2,374,3.4,4,0.0,5354,49.3,5503,5503,(X),6.8,5522,5522,2624,47.5,2624,47.5,2469,44.7,975,975,608,62.4,1858,1858,1132,60.9
29183,307734,307734,215880,70.2,215715,70.1,208527,67.8,7188,2.3,165,0.1,91854,29.8,215715,215715,(X),3.3,157774,157774,102726,65.1,102712,65.1,99518,63.1,27997,27997,20421,72.9,62335,62335,50502,81.0
29185,7741,7741,3746,48.4,3746,48.4,3592,46.4,154,2.0,0,0.0,3995,51.6,3746,3746,(X),4.1,3884,3884,1692,43.6,1692,43.6,1599,41.2,547,547,447,81.7,1092,1092,843,77.2
29186,14471,14471,9156,63.3,9156,63.3,8758,60.5,398,2.8,0,0.0,5315,36.7,9156,9156,(X),4.3,7269,7269,4381,60.3,4381,60.3,4174,57.4,1056,1056,796,75.4,2688,2688,2278,84.7
29187,54059,54059,28621,52.9,28621,52.9,26991,49.9,1630,3.0,0,0.0,25438,47.1,28621,28621,(X),5.7,24378,24378,13501,55.4,13501,55.4,12752,52.3,3937,3937,2638,67.0,8915,8915,6406,71.9
29189,803924,803924,524849,65.3,524576,65.3,497435,61.9,27141,3.4,273,0.0,279075,34.7,524576,524576,(X),5.2,429376,429376,260730,60.7,260667,60.7,248019,57.8,67402,67402,50709,75.2,143779,143779,111972,77.9
29195,18420,18420,10955,59.5,10955,59.5,10523,57.1,432,2.3,0,0.0,7465,40.5,10955,10955,(X),3.9,9159,9159,5143,56.2,5143,56.2,4943,54.0,1723,1723,1247,72.4,3156,3156,2686,85.1
29197,3446,3446,1975,57.3,1975,57.3,1896,55.0,79,2.3,0,0.0,1471,42.7,1975,1975,(X),4.0,1771,1771,971,54.8,971,54.8,955,53.9,387,387,170,43.9,725,725,536,73.9
29199,3654,3654,2202,60.3,2202,60.3,2092,57.3,110,3.0,0,0.0,1452,39.7,2202,2202,(X),5.0,1912,1912,871,45.6,871,45.6,822,43.0,429,429,109,25.4,932,932,372,39.9
29201,30572,30572,17754,58.1,17710,57.9,16789,54.9,921,3.0,44,0.1,12818,41.9,17710,17710,(X),5.2,16067,16067,8656,53.9,8649,53.8,8224,51.2,2927,2927,2047,69.9,5547,5547,3932,70.9
29203,6627,6627,3099,46.8,3099,46.8,2903,43.8,196,3.0,0,0.0,3528,53.2,3099,3099,(X),6.3,3448,3448,1378,40.0,1378,40.0,1290,37.4,531,531,313,58.9,1091,1091,596,54.6
29205,4777,4777,3052,63.9,3050,63.8,2945,61.6,105,2.2,2,0.0,1725,36.1,3050,3050,(X),3.4,2413,2413,1419,58.8,1417,58.7,1356,56.2,438,438,349,79.7,869,869,696,80.1
29207,23841,23841,13402,56.2,13376,56.1,12599,52.8,777,3.3,26,0.1,10439,43.8,13376,13376,(X),5.8,12335,12335,6188,50.2,6173,50.0,5813,47.1,2063,2063,1277,61.9,4054,4054,2808,69.3
29209,27071,27071,12958,47.9,12954,47.9,12088,44.7,866,3.2,4,0.0,14113,52.1,12954,12954,(X),6.7,13907,13907,6037,43.4,6037,43.4,5519,39.7,1364,1364,664,48.7,3614,3614,2085,57.7
29211,5030,5030,2743,54.5,2732,54.3,2648,52.6,84,1.7,11,0.2,2287,45.5,2732,2732,(X),3.1,2602,2602,1289,49.5,1289,49.5,1264,48.6,448,448,262,58.5,871,871,624,71.6
29213,44488,44488,26131,58.7,26131,58.7,24618,55.3,1513,3.4,0,0.0,18357,41.3,26131,26131,(X),5.8,23223,23223,12691,54.6,12691,54.6,11989,51.6,3561,3561,2284,64.1,7163,7163,5387,75.2
29215,20802,20802,9656,46.4,9565,46.0,8695,41.8,870,4.2,91,0.4,11146,53.6,9565,9565,(X),9.1,9932,9932,4292,43.2,4280,43.1,4063,40.9,1567,1567,808,51.6,3591,3591,2033,56.6
29217,16280,16280,9920,60.9,9891,60.8,9527,58.5,364,2.2,29,0.2,6360,39.1,9891,9891,(X),3.7,8532,8532,4746,55.6,4746,55.6,4579,53.7,1462,1462,974,66.6,3038,3038,2061,67.8
29219,26569,26569,15871,59.7,15871,59.7,14974,56.4,897,3.4,0,0.0,10698,40.3,15871,15871,(X),5.7,13451,13451,7114,52.9,7114,52.9,6770,50.3,2667,2667,1696,63.6,5113,5113,3691,72.2
29221,19955,19955,9921,49.7,9921,49.7,9032,45.3,889,4.5,0,0.0,10034,50.3,9921,9921,(X),9.0,9644,9644,4672,48.4,4672,48.4,4208,43.6,1633,1633,1031,63.1,3693,3693,2540,68.8
29223,10855,10855,4656,42.9,4656,42.9,4236,39.0,420,3.9,0,0.0,6199,57.1,4656,4656,(X),9.0,5470,5470,2250,41.1,2250,41.1,2135,39.0,694,694,399,57.5,1830,1830,1058,57.8
29225,28748,28748,16344,56.9,16301,56.7,15534,54.0,767,2.7,43,0.1,12404,43.1,16301,16301,(X),4.7,14223,14223,6943,48.8,6943,48.8,6653,46.8,3274,3274,1404,42.9,6298,6298,3445,54.7
29227,1653,1653,964,58.3,961,58.1,924,55.9,37,2.2,3,0.2,689,41.7,961,961,(X),3.9,861,861,444,51.6,444,51.6,432,50.2,148,148,117,79.1,248,248,155,62.5
29229,14214,14214,7280,51.2,7273,51.2,6688,47.1,585,4.1,7,0.0,6934,48.8,7273,7273,(X),8.0,7242,7242,3334,46.0,3330,46.0,3094,42.7,1270,1270,475,37.4,2855,2855,1511,52.9
29510,256154,256154,167945,65.6,167581,65.4,153691,60.0,13890,5.4,364,0.1,88209,34.4,167581,167581,(X),8.3,133801,133801,85281,63.7,85248,63.7,78692,58.8,22224,22224,16690,75.1,34920,34920,26208,75.1
30001,7960,7960,4890,61.4,4890,61.4,4706,59.1,184,2.3,0,0.0,3070,38.6,4890,4890,(X),3.8,3914,3914,2374,60.7,2374,60.7,2265,57.9,556,556,426,76.6,1073,1073,860,80.1
30003,9268,9268,5467,59.0,5459,58.9,4725,51.0,734,7.9,8,0.1,3801,41.0,5459,5459,(X),13.4,4817,4817,2628,54.6,2620,54.4,2369,49.2,1378,1378,836,60.7,2548,2548,1722,67.6
30005,4919,4919,3039,61.8,3039,61.8,2577,52.4,462,9.4,0,0.0,1880,38.2,3039,3039,(X),15.2,2504,2504,1466,58.5,1466,58.5,1256,50.2,650,650,413,63.5,1140,1140,652,57.2
30007,4865,4865,2862,58.8,2862,58.8,2686,55.2,176,3.6,0,0.0,2003,41.2,2862,2862,(X),6.1,2410,2410,1348,55.9,1348,55.9,1276,52.9,313,313,140,44.7,819,819,527,64.3
30009,8881,8881,5434,61.2,5408,60.9,5208,58.6,200,2.3,26,0.3,3447,38.8,5408,5408,(X),3.7,4428,4428,2576,58.2,2576,58.2,2454,55.4,448,448,282,62.9,1421,1421,1137,80.0
30011,1075,1075,657,61.1,657,61.1,643,59.8,14,1.3,0,0.0,418,38.9,657,657,(X),2.1,547,547,290,53.0,290,53.0,283,51.7,85,85,38,44.7,170,170,70,41.2
30013,64998,64998,40868,62.9,38479,59.2,36909,56.8,1570,2.4,2389,3.7,24130,37.1,38479,38479,(X),4.1,32508,32508,18948,58.3,18690,57.5,18052,55.5,6301,6301,4019,63.8,11017,11017,8249,74.9
30015,4601,4601,2603,56.6,2592,56.3,2516,54.7,76,1.7,11,0.2,1998,43.4,2592,2592,(X),2.9,2310,2310,1142,49.4,1142,49.4,1097,47.5,390,390,161,41.3,900,900,522,58.0
30017,9629,9629,6611,68.7,6596,68.5,6463,67.1,133,1.4,15,0.2,3018,31.3,6596,6596,(X),2.0,4893,4893,3320,67.9,3320,67.9,3261,66.6,827,827,601,72.7,1567,1567,1286,82.1
30019,1445,1445,890,61.6,890,61.6,876,60.6,14,1.0,0,0.0,555,38.4,890,890,(X),1.6,718,718,391,54.5,391,54.5,377,52.5,119,119,81,68.1,224,224,132,58.9
30021,7424,7424,5002,67.4,5002,67.4,4928,66.4,74,1.0,0,0.0,2422,32.6,5002,5002,(X),1.5,3470,3470,2070,59.7,2070,59.7,2045,58.9,695,695,489,70.4,1056,1056,914,86.6
30023,7939,7939,3782,47.6,3782,47.6,3667,46.2,115,1.4,0,0.0,4157,52.4,3782,3782,(X),3.0,3662,3662,1841,50.3,1841,50.3,1771,48.4,343,343,246,71.7,877,877,660,75.3
30025,2239,2239,1565,69.9,1565,69.9,1530,68.3,35,1.6,0,0.0,674,30.1,1565,1565,(X),2.2,1079,1079,595,55.1,595,55.1,580,53.8,185,185,74,40.0,453,453,410,90.5
30027,9201,9201,5872,63.8,5872,63.8,5735,62.3,137,1.5,0,0.0,3329,36.2,5872,5872,(X),2.3,4602,4602,2671,58.0,2671,58.0,2640,57.4,765,765,608,79.5,1401,1401,1193,85.2
30029,78765,78765,49190,62.5,49187,62.4,47354,60.1,1833,2.3,3,0.0,29575,37.5,49187,49187,(X),3.7,39957,39957,23165,58.0,23165,58.0,22410,56.1,6679,6679,3896,58.3,13957,13957,9634,69.0
30031,85611,85611,61825,72.2,61751,72.1,59736,69.8,2015,2.4,74,0.1,23786,27.8,61751,61751,(X),3.3,41167,41167,27411,66.6,27379,66.5,26477,64.3,7287,7287,4243,58.2,13580,13580,9508,70.0
30033,925,925,617,66.7,617,66.7,617,66.7,0,0.0,0,0.0,308,33.3,617,617,(X),0.0,468,468,288,61.5,288,61.5,288,61.5,107,107,80,74.8,130,130,89,68.5
30035,9661,9661,5031,52.1,5021,52.0,4646,48.1,375,3.9,10,0.1,4630,47.9,5021,5021,(X),7.5,4959,4959,2361,47.6,2361,47.6,2253,45.4,1296,1296,602,46.5,2503,2503,1490,59.5
30037,615,615,366,59.5,366,59.5,353,57.4,13,2.1,0,0.0,249,40.5,366,366,(X),3.6,311,311,183,58.8,183,58.8,171,55.0,26,26,16,61.5,84,84,43,51.2
30039,2773,2773,1288,46.4,1288,46.4,1231,44.4,57,2.1,0,0.0,1485,53.6,1288,1288,(X),4.4,1353,1353,640,47.3,640,47.3,605,44.7,133,133,104,78.2,417,417,267,64.0
30041,12398,12398,7657,61.8,7653,61.7,7171,57.8,482,3.9,4,0.0,4741,38.2,7653,7653,(X),6.3,6139,6139,3538,57.6,3538,57.6,3405,55.5,1524,1524,878,57.6,2694,2694,2022,75.1
30043,9712,9712,5710,58.8,5675,58.4,5400,55.6,275,2.8,35,0.4,4002,41.2,5675,5675,(X),4.8,4758,4758,2607,54.8,2607,54.8,2469,51.9,535,535,436,81.5,1806,1806,1474,81.6
30045,1669,1669,1017,60.9,1017,60.9,984,59.0,33,2.0,0,0.0,652,39.1,1017,1017,(X),3.2,762,762,427,56.0,427,56.0,416,54.6,113,113,50,44.2,236,236,212,89.8
30047,23377,23377,13101,56.0,13094,56.0,12300,52.6,794,3.4,7,0.0,10276,44.0,13094,13094,(X),6.1,11929,11929,6354,53.3,6354,53.3,6121,51.3,2220,2220,1394,62.8,4107,4107,2755,67.1
30049,54059,54059,35747,66.1,35562,65.8,34454,63.7,1108,2.0,185,0.3,18312,33.9,35562,35562,(X),3.1,27509,27509,17413,63.3,17344,63.0,16979,61.7,4620,4620,3417,74.0,9259,9259,7190,77.7
30051,1839,1839,1132,61.6,1132,61.6,1126,61.2,6,0.3,0,0.0,707,38.4,1132,1132,(X),0.5,966,966,512,53.0,512,53.0,512,53.0,155,155,75,48.4,339,339,155,45.7
30053,16251,16251,7599,46.8,7588,46.7,6802,41.9,786,4.8,11,0.1,8652,53.2,7588,7588,(X),10.4,8181,8181,3566,43.6,3566,43.6,3202,39.1,973,973,465,47.8,2261,2261,1242,54.9
30055,1310,1310,785,59.9,785,59.9,783,59.8,2,0.2,0,0.0,525,40.1,785,785,(X),0.3,631,631,318,50.4,318,50.4,318,50.4,81,81,33,40.7,239,239,138,57.7
30057,7102,7102,4159,58.6,4159,58.6,4023,56.6,136,1.9,0,0.0,2943,41.4,4159,4159,(X),3.3,3345,3345,1783,53.3,1783,53.3,1745,52.2,437,437,303,69.3,776,776,465,59.9
30059,1624,1624,997,61.4,997,61.4,980,60.3,17,1.0,0,0.0,627,38.6,997,997,(X),1.7,797,797,454,57.0,454,57.0,448,56.2,161,161,100,62.1,228,228,182,79.8
30061,3580,3580,1723,48.1,1698,47.4,1583,44.2,115,3.2,25,0.7,1857,51.9,1698,1698,(X),6.8,1716,1716,834,48.6,834,48.6,809,47.1,228,228,170,74.6,499,499,294,58.9
30063,96149,96149,67146,69.8,67057,69.7,64178,66.7,2879,3.0,89,0.1,29003,30.2,67057,67057,(X),4.3,48056,48056,32449,67.5,32435,67.5,31201,64.9,7177,7177,5543,77.2,14196,14196,11418,80.4
30065,3875,3875,1899,49.0,1899,49.0,1781,46.0,118,3.0,0,0.0,1976,51.0,1899,1899,(X),6.2,1933,1933,897,46.4,897,46.4,830,42.9,340,340,174,51.2,597,597,323,54.1
30067,13620,13620,8588,63.1,8569,62.9,8327,61.1,242,1.8,19,0.1,5032,36.9,8569,8569,(X),2.8,6879,6879,4021,58.5,4021,58.5,3904,56.8,895,895,581,64.9,1953,1953,1509,77.3
30069,356,356,235,66.0,235,66.0,228,64.0,7,2.0,0,0.0,121,34.0,235,235,(X),3.0,180,180,110,61.1,110,61.1,110,61.1,31,31,28,90.3,42,42,28,66.7
30071,3241,3241,1850,57.1,1850,57.1,1723,53.2,127,3.9,0,0.0,1391,42.9,1850,1850,(X),6.9,1625,1625,872,53.7,872,53.7,814,50.1,372,372,181,48.7,561,561,438,78.1
30073,4678,4678,2750,58.8,2750,58.8,2560,54.7,190,4.1,0,0.0,1928,41.2,2750,2750,(X),6.9,2350,2350,1257,53.5,1257,53.5,1197,50.9,506,506,317,62.6,875,875,658,75.2
30075,1420,1420,978,68.9,978,68.9,965,68.0,13,0.9,0,0.0,442,31.1,978,978,(X),1.3,714,714,411,57.6,411,57.6,404,56.6,82,82,54,65.9,151,151,119,78.8
30077,6000,6000,2618,43.6,2618,43.6,2594,43.2,24,0.4,0,0.0,3382,56.4,2618,2618,(X),0.9,2129,2129,1078,50.6,1078,50.6,1075,50.5,321,321,159,49.5,659,659,392,59.5
30079,1057,1057,634,60.0,634,60.0,604,57.1,30,2.8,0,0.0,423,40.0,634,634,(X),4.7,527,527,313,59.4,313,59.4,292,55.4,88,88,58,65.9,213,213,123,57.7
30081,34589,34589,19140,55.3,19140,55.3,18010,52.1,1130,3.3,0,0.0,15449,44.7,19140,19140,(X),5.9,17609,17609,9143,51.9,9143,51.9,8596,48.8,2152,2152,1329,61.8,5491,5491,3891,70.9
30083,8977,8977,6241,69.5,6241,69.5,6090,67.8,151,1.7,0,0.0,2736,30.5,6241,6241,(X),2.4,4399,4399,2654,60.3,2654,60.3,2582,58.7,915,915,517,56.5,1755,1755,1417,80.7
30085,7904,7904,4412,55.8,4412,55.8,3884,49.1,528,6.7,0,0.0,3492,44.2,4412,4412,(X),12.0,3980,3980,1971,49.5,1971,49.5,1770,44.5,1105,1105,646,58.5,2111,2111,1235,58.5
30087,6926,6926,4222,61.0,4216,60.9,3883,56.1,333,4.8,6,0.1,2704,39.0,4216,4216,(X),7.9,3543,3543,1857,52.4,1857,52.4,1738,49.1,708,708,289,40.8,1683,1683,1163,69.1
30089,9652,9652,4422,45.8,4422,45.8,4049,41.9,373,3.9,0,0.0,5230,54.2,4422,4422,(X),8.4,4751,4751,2007,42.2,2007,42.2,1777,37.4,607,607,281,46.3,1289,1289,782,60.7
30091,2870,2870,1909,66.5,1909,66.5,1855,64.6,54,1.9,0,0.0,961,33.5,1909,1909,(X),2.8,1435,1435,813,56.7,813,56.7,787,54.8,308,308,138,44.8,418,418,289,69.1
30093,28512,28512,17269,60.6,17258,60.5,16396,57.5,862,3.0,11,0.0,11243,39.4,17258,17258,(X),5.0,14162,14162,8075,57.0,8075,57.0,7679,54.2,2234,2234,1421,63.6,4297,4297,3495,81.3
30095,7639,7639,4663,61.0,4656,61.0,4475,58.6,181,2.4,7,0.1,2976,39.0,4656,4656,(X),3.9,3766,3766,2094,55.6,2094,55.6,1979,52.5,447,447,208,46.5,1477,1477,1084,73.4
30097,2995,2995,1641,54.8,1641,54.8,1628,54.4,13,0.4,0,0.0,1354,45.2,1641,1641,(X),0.8,1557,1557,748,48.0,748,48.0,748,48.0,161,161,104,64.6,557,557,461,82.8
30099,4784,4784,2723,56.9,2711,56.7,2661,55.6,50,1.0,12,0.3,2061,43.1,2711,2711,(X),1.8,2419,2419,1192,49.3,1190,49.2,1185,49.0,467,467,196,42.0,938,938,587,62.6
30101,4113,4113,2200,53.5,2200,53.5,2181,53.0,19,0.5,0,0.0,1913,46.5,2200,2200,(X),0.9,1725,1725,967,56.1,967,56.1,963,55.8,280,280,115,41.1,643,643,418,65.0
30103,646,646,379,58.7,379,58.7,379,58.7,0,0.0,0,0.0,267,41.3,379,379,(X),0.0,337,337,183,54.3,183,54.3,183,54.3,38,38,23,60.5,111,111,91,82.0
30105,6113,6113,4033,66.0,4033,66.0,3808,62.3,225,3.7,0,0.0,2080,34.0,4033,4033,(X),5.6,3153,3153,1994,63.2,1994,63.2,1965,62.3,465,465,340,73.1,1063,1063,888,83.5
30107,1674,1674,1009,60.3,1009,60.3,975,58.2,34,2.0,0,0.0,665,39.7,1009,1009,(X),3.4,858,858,485,56.5,485,56.5,458,53.4,182,182,134,73.6,321,321,256,79.8
30109,880,880,579,65.8,579,65.8,567,64.4,12,1.4,0,0.0,301,34.2,579,579,(X),2.1,450,450,280,62.2,280,62.2,271,60.2,130,130,129,99.2,188,188,169,89.9
30111,124423,124423,83828,67.4,83603,67.2,80736,64.9,2867,2.3,225,0.2,40595,32.6,83603,83603,(X),3.4,63591,63591,39707,62.4,39707,62.4,38477,60.5,11616,11616,7948,68.4,23603,23603,17570,74.4
31001,24988,24988,16494,66.0,16491,66.0,15946,63.8,545,2.2,3,0.0,8494,34.0,16491,16491,(X),3.3,12544,12544,7731,61.6,7731,61.6,7403,59.0,2302,2302,1630,70.8,4880,4880,3694,75.7
31003,5078,5078,3301,65.0,3297,64.9,3232,63.6,65,1.3,4,0.1,1777,35.0,3297,3297,(X),2.0,2563,2563,1507,58.8,1507,58.8,1479,57.7,471,471,322,68.4,997,997,743,74.5
31005,317,317,198,62.5,198,62.5,196,61.8,2,0.6,0,0.0,119,37.5,198,198,(X),1.0,162,162,85,52.5,85,52.5,83,51.2,24,24,18,75.0,84,84,75,89.3
31007,559,559,410,73.3,410,73.3,405,72.5,5,0.9,0,0.0,149,26.7,410,410,(X),1.2,294,294,193,65.6,193,65.6,191,65.0,49,49,36,73.5,95,95,77,81.1
31009,383,383,264,68.9,264,68.9,264,68.9,0,0.0,0,0.0,119,31.1,264,264,(X),0.0,174,174,99,56.9,99,56.9,99,56.9,34,34,22,64.7,71,71,54,76.1
31011,4222,4222,2912,69.0,2911,68.9,2862,67.8,49,1.2,1,0.0,1310,31.0,2911,2911,(X),1.7,2131,2131,1290,60.5,1290,60.5,1267,59.5,449,449,383,85.3,763,763,601,78.8
31013,8596,8596,5622,65.4,5622,65.4,5332,62.0,290,3.4,0,0.0,2974,34.6,5622,5622,(X),5.2,4385,4385,2454,56.0,2454,56.0,2339,53.3,820,820,628,76.6,1932,1932,1456,75.4
31015,1671,1671,1017,60.9,1017,60.9,1002,60.0,15,0.9,0,0.0,654,39.1,1017,1017,(X),1.5,830,830,441,53.1,441,53.1,434,52.3,114,114,81,71.1,289,289,280,96.9
31017,2447,2447,1526,62.4,1526,62.4,1517,62.0,9,0.4,0,0.0,921,37.6,1526,1526,(X),0.6,1278,1278,691,54.1,691,54.1,689,53.9,160,160,115,71.9,416,416,311,74.8
31019,38723,38723,28549,73.7,28541,73.7,27694,71.5,847,2.2,8,0.0,10174,26.3,28541,28541,(X),3.0,19530,19530,13460,68.9,13460,68.9,13049,66.8,3979,3979,2927,73.6,6989,6989,5684,81.3
31021,5210,5210,3120,59.9,3120,59.9,3028,58.1,92,1.8,0,0.0,2090,40.1,3120,3120,(X),2.9,2698,2698,1561,57.9,1561,57.9,1507,55.9,426,426,283,66.4,997,997,754,75.6
31023,6438,6438,4324,67.2,4323,67.1,4187,65.0,136,2.1,1,0.0,2114,32.8,4323,4323,(X),3.1,3196,3196,1927,60.3,1927,60.3,1859,58.2,591,591,399,67.5,1239,1239,975,78.7
31025,20159,20159,13763,68.3,13630,67.6,13225,65.6,405,2.0,133,0.7,6396,31.7,13630,13630,(X),3.0,10130,10130,6379,63.0,6345,62.6,6165,60.9,2013,2013,1498,74.4,3960,3960,3143,79.4
31027,6633,6633,4595,69.3,4595,69.3,4538,68.4,57,0.9,0,0.0,2038,30.7,4595,4595,(X),1.2,3328,3328,2146,64.5,2146,64.5,2113,63.5,699,699,577,82.5,1392,1392,1201,86.3
31029,3035,3035,2069,68.2,2069,68.2,2018,66.5,51,1.7,0,0.0,966,31.8,2069,2069,(X),2.5,1540,1540,907,58.9,907,58.9,882,57.3,179,179,113,63.1,546,546,457,83.7
31031,4676,4676,3225,69.0,3225,69.0,3173,67.9,52,1.1,0,0.0,1451,31.0,3225,3225,(X),1.6,2415,2415,1570,65.0,1570,65.0,1526,63.2,456,456,300,65.8,733,733,634,86.5
31033,7732,7732,5507,71.2,5507,71.2,5354,69.2,153,2.0,0,0.0,2225,28.8,5507,5507,(X),2.8,3893,3893,2551,65.5,2551,65.5,2488,63.9,793,793,618,77.9,1539,1539,1143,74.3
31035,4888,4888,3135,64.1,3135,64.1,3023,61.8,112,2.3,0,0.0,1753,35.9,3135,3135,(X),3.6,2418,2418,1389,57.4,1389,57.4,1345,55.6,460,460,348,75.7,983,983,780,79.3
31037,7800,7800,5567,71.4,5511,70.7,5337,68.4,174,2.2,56,0.7,2233,28.6,5511,5511,(X),3.2,3528,3528,2247,63.7,2247,63.7,2217,62.8,998,998,706,70.7,1826,1826,1317,72.1
31039,7005,7005,4859,69.4,4859,69.4,4687,66.9,172,2.5,0,0.0,2146,30.6,4859,4859,(X),3.5,3439,3439,2093,60.9,2093,60.9,2031,59.1,654,654,476,72.8,1504,1504,1242,82.6
31041,8564,8564,5683,66.4,5682,66.3,5517,64.4,165,1.9,1,0.0,2881,33.6,5682,5682,(X),2.9,4323,4323,2490,57.6,2490,57.6,2413,55.8,737,737,473,64.2,1631,1631,1334,81.8
31043,15005,15005,10863,72.4,10857,72.4,10275,68.5,582,3.9,6,0.0,4142,27.6,10857,10857,(X),5.4,7530,7530,4961,65.9,4961,65.9,4612,61.2,2002,2002,1275,63.7,3500,3500,2293,65.5
31045,7508,7508,4647,61.9,4643,61.8,4587,61.1,56,0.7,4,0.1,2861,38.1,4643,4643,(X),1.2,3694,3694,2112,57.2,2112,57.2,2087,56.5,616,616,406,65.9,927,927,695,75.0
31047,18083,18083,12676,70.1,12665,70.0,12194,67.4,471,2.6,11,0.1,5407,29.9,12665,12665,(X),3.7,8805,8805,5651,64.2,5651,64.2,5472,62.1,2243,2243,1720,76.7,3934,3934,3279,83.4
31049,1535,1535,975,63.5,975,63.5,928,60.5,47,3.1,0,0.0,560,36.5,975,975,(X),4.8,812,812,456,56.2,456,56.2,436,53.7,133,133,105,78.9,217,217,167,77.0
31051,4464,4464,3041,68.1,3041,68.1,2941,65.9,100,2.2,0,0.0,1423,31.9,3041,3041,(X),3.3,2212,2212,1398,63.2,1398,63.2,1353,61.2,463,463,352,76.0,953,953,796,83.5
31053,28827,28827,19632,68.1,19631,68.1,18723,64.9,908,3.1,1,0.0,9195,31.9,19631,19631,(X),4.6,14795,14795,9412,63.6,9411,63.6,8795,59.4,2785,2785,1756,63.1,5442,5442,4026,74.0
31055,427154,427154,302528,70.8,301643,70.6,288884,67.6,12759,3.0,885,0.2,124626,29.2,301643,301643,(X),4.2,218842,218842,144923,66.2,144757,66.1,139031,63.5,49029,49029,35718,72.9,87611,87611,67759,77.3
31057,1525,1525,954,62.6,954,62.6,939,61.6,15,1.0,0,0.0,571,37.4,954,954,(X),1.6,795,795,425,53.5,425,53.5,415,52.2,150,150,107,71.3,384,384,275,71.6
31059,4591,4591,2875,62.6,2870,62.5,2811,61.2,59,1.3,5,0.1,1716,37.4,2870,2870,(X),2.1,2328,2328,1310,56.3,1305,56.1,1259,54.1,291,291,229,78.7,731,731,603,82.5
31061,2517,2517,1522,60.5,1522,60.5,1498,59.5,24,1.0,0,0.0,995,39.5,1522,1522,(X),1.6,1280,1280,732,57.2,732,57.2,718,56.1,175,175,133,76.0,375,375,290,77.3
31063,2170,2170,1303,60.0,1303,60.0,1254,57.8,49,2.3,0,0.0,867,40.0,1303,1303,(X),3.8,1079,1079,600,55.6,600,55.6,570,52.8,162,162,122,75.3,345,345,293,84.9
31065,3870,3870,2436,62.9,2436,62.9,2384,61.6,52,1.3,0,0.0,1434,37.1,2436,2436,(X),2.1,1970,1970,1098,55.7,1098,55.7,1081,54.9,283,283,214,75.6,665,665,511,76.8
31067,17341,17341,11399,65.7,11399,65.7,11016,63.5,383,2.2,0,0.0,5942,34.3,11399,11399,(X),3.4,8789,8789,5378,61.2,5378,61.2,5221,59.4,1454,1454,1112,76.5,3036,3036,2519,83.0
31069,1534,1534,893,58.2,877,57.2,865,56.4,12,0.8,16,1.0,641,41.8,877,877,(X),1.4,756,756,364,48.1,364,48.1,355,47.0,85,85,66,77.6,283,283,203,71.7
31071,1617,1617,1020,63.1,1020,63.1,1018,63.0,2,0.1,0,0.0,597,36.9,1020,1020,(X),0.2,834,834,477,57.2,477,57.2,477,57.2,119,119,113,95.0,257,257,206,80.2
31073,1677,1677,1134,67.6,1134,67.6,1101,65.7,33,2.0,0,0.0,543,32.4,1134,1134,(X),2.9,886,886,549,62.0,549,62.0,527,59.5,67,67,60,89.6,319,319,316,99.1
31075,581,581,378,65.1,375,64.5,359,61.8,16,2.8,3,0.5,203,34.9,375,375,(X),4.3,276,276,178,64.5,178,64.5,164,59.4,69,69,28,40.6,81,81,54,66.7
31077,1915,1915,1207,63.0,1207,63.0,1190,62.1,17,0.9,0,0.0,708,37.0,1207,1207,(X),1.4,963,963,533,55.3,533,55.3,522,54.2,198,198,156,78.8,342,342,284,83.0
31079,46402,46402,32933,71.0,32894,70.9,31413,67.7,1481,3.2,39,0.1,13469,29.0,32894,32894,(X),4.5,23398,23398,15362,65.7,15362,65.7,14649,62.6,5412,5412,3805,70.3,10433,10433,7659,73.4
31081,7300,7300,5007,68.6,5003,68.5,4880,66.8,123,1.7,4,0.1,2293,31.4,5003,5003,(X),2.5,3743,3743,2327,62.2,2325,62.1,2294,61.3,594,594,465,78.3,1471,1471,1187,80.7
31083,2772,2772,1670,60.2,1670,60.2,1646,59.4,24,0.9,0,0.0,1102,39.8,1670,1670,(X),1.4,1327,1327,721,54.3,721,54.3,706,53.2,256,256,188,73.4,516,516,468,90.7
31085,757,757,499,65.9,499,65.9,494,65.3,5,0.7,0,0.0,258,34.1,499,499,(X),1.0,356,356,221,62.1,221,62.1,216,60.7,74,74,38,51.4,131,131,107,81.7
31087,2276,2276,1371,60.2,1371,60.2,1315,57.8,56,2.5,0,0.0,905,39.8,1371,1371,(X),4.1,1158,1158,639,55.2,639,55.2,609,52.6,179,179,124,69.3,432,432,337,78.0
31089,7948,7948,5721,72.0,5717,71.9,5655,71.1,62,0.8,4,0.1,2227,28.0,5717,5717,(X),1.1,4008,4008,2646,66.0,2646,66.0,2622,65.4,724,724,569,78.6,1638,1638,1395,85.2
31091,595,595,283,47.6,283,47.6,282,47.4,1,0.2,0,0.0,312,52.4,283,283,(X),0.4,303,303,128,42.2,128,42.2,128,42.2,29,29,10,34.5,68,68,39,57.4
31093,5023,5023,3443,68.5,3443,68.5,3331,66.3,112,2.2,0,0.0,1580,31.5,3443,3443,(X),3.3,2523,2523,1658,65.7,1658,65.7,1629,64.6,470,470,415,88.3,1042,1042,835,80.1
31095,5769,5769,3620,62.7,3620,62.7,3558,61.7,62,1.1,0,0.0,2149,37.3,3620,3620,(X),1.7,2953,2953,1676,56.8,1676,56.8,1664,56.3,498,498,299,60.0,1064,1064,765,71.9
31097,4360,4360,2170,49.8,2161,49.6,2117,48.6,44,1.0,9,0.2,2190,50.2,2161,2161,(X),2.0,1695,1695,987,58.2,978,57.7,951,56.1,293,293,222,75.8,668,668,542,81.1
31099,5125,5125,3520,68.7,3520,68.7,3420,66.7,100,2.0,0,0.0,1605,31.3,3520,3520,(X),2.8,2592,2592,1624,62.7,1624,62.7,1550,59.8,488,488,418,85.7,1032,1032,838,81.2
31101,6658,6658,4302,64.6,4302,64.6,4142,62.2,160,2.4,0,0.0,2356,35.4,4302,4302,(X),3.7,3290,3290,1902,57.8,1902,57.8,1875,57.0,407,407,278,68.3,1158,1158,966,83.4
31103,639,639,457,71.5,457,71.5,457,71.5,0,0.0,0,0.0,182,28.5,457,457,(X),0.0,308,308,195,63.3,195,63.3,195,63.3,58,58,46,79.3,120,120,67,55.8
31105,2956,2956,1877,63.5,1871,63.3,1734,58.7,137,4.6,6,0.2,1079,36.5,1871,1871,(X),7.3,1436,1436,911,63.4,911,63.4,848,59.1,264,264,186,70.5,556,556,433,77.9
31107,6713,6713,4390,65.4,4388,65.4,4249,63.3,139,2.1,2,0.0,2323,34.6,4388,4388,(X),3.2,3410,3410,2047,60.0,2045,60.0,1978,58.0,601,601,495,82.4,1377,1377,1104,80.2
31109,245961,245961,176024,71.6,175535,71.4,169556,68.9,5979,2.4,489,0.2,69937,28.4,175535,175535,(X),3.4,123058,123058,84304,68.5,84206,68.4,81511,66.2,23729,23729,17732,74.7,45082,45082,37125,82.3
31111,27814,27814,17746,63.8,17725,63.7,17242,62.0,483,1.7,21,0.1,10068,36.2,17725,17725,(X),2.7,14129,14129,7869,55.7,7869,55.7,7658,54.2,2379,2379,1347,56.6,5575,5575,4231,75.9
31113,668,668,451,67.5,451,67.5,451,67.5,0,0.0,0,0.0,217,32.5,451,451,(X),0.0,348,348,201,57.8,201,57.8,201,57.8,62,62,32,51.6,187,187,116,62.0
31115,508,508,307,60.4,307,60.4,305,60.0,2,0.4,0,0.0,201,39.6,307,307,(X),0.7,255,255,134,52.5,134,52.5,132,51.8,34,34,12,35.3,48,48,44,91.7
31117,364,364,222,61.0,222,61.0,222,61.0,0,0.0,0,0.0,142,39.0,222,222,(X),0.0,184,184,96,52.2,96,52.2,96,52.2,33,33,27,81.8,71,71,48,67.6
31119,27089,27089,19105,70.5,19096,70.5,18521,68.4,575,2.1,9,0.0,7984,29.5,19096,19096,(X),3.0,13702,13702,8840,64.5,8840,64.5,8530,62.3,3032,3032,2303,76.0,5448,5448,4435,81.4
31121,6308,6308,4204,66.6,4204,66.6,4091,64.9,113,1.8,0,0.0,2104,33.4,4204,4204,(X),2.7,3138,3138,1957,62.4,1957,62.4,1890,60.2,579,579,454,78.4,1077,1077,858,79.7
31123,3810,3810,2526,66.3,2522,66.2,2382,62.5,140,3.7,4,0.1,1284,33.7,2522,2522,(X),5.6,1859,1859,1148,61.8,1148,61.8,1107,59.5,282,282,253,89.7,708,708,570,80.5
31125,2854,2854,1820,63.8,1820,63.8,1760,61.7,60,2.1,0,0.0,1034,36.2,1820,1820,(X),3.3,1461,1461,881,60.3,881,60.3,840,57.5,211,211,196,92.9,582,582,531,91.2
31127,5724,5724,3564,62.3,3560,62.2,3401,59.4,159,2.8,4,0.1,2160,37.7,3560,3560,(X),4.5,2927,2927,1705,58.3,1705,58.3,1620,55.3,442,442,288,65.2,963,963,776,80.6
31129,3515,3515,2256,64.2,2256,64.2,2224,63.3,32,0.9,0,0.0,1259,35.8,2256,2256,(X),1.4,1768,1768,1011,57.2,1011,57.2,993,56.2,287,287,270,94.1,565,565,467,82.7
31131,12495,12495,8467,67.8,8457,67.7,8223,65.8,234,1.9,10,0.1,4028,32.2,8457,8457,(X),2.8,6474,6474,4211,65.0,4201,64.9,4098,63.3,1265,1265,993,78.5,2341,2341,1927,82.3
31133,2172,2172,1255,57.8,1255,57.8,1213,55.8,42,1.9,0,0.0,917,42.2,1255,1255,(X),3.3,1140,1140,562,49.3,562,49.3,549,48.2,198,198,118,59.6,347,347,241,69.5
31135,2266,2266,1514,66.8,1514,66.8,1497,66.1,17,0.8,0,0.0,752,33.2,1514,1514,(X),1.1,1120,1120,670,59.8,670,59.8,663,59.2,222,222,156,70.3,470,470,326,69.4
31137,7219,7219,4826,66.9,4824,66.8,4788,66.3,36,0.5,2,0.0,2393,33.1,4824,4824,(X),0.7,3670,3670,2185,59.5,2183,59.5,2165,59.0,625,625,508,81.3,1437,1437,1309,91.1
31139,5609,5609,3880,69.2,3878,69.1,3787,67.5,91,1.6,2,0.0,1729,30.8,3878,3878,(X),2.3,2830,2830,1874,66.2,1874,66.2,1810,64.0,562,562,456,81.1,1139,1139,894,78.5
31141,25518,25518,18424,72.2,18424,72.2,17724,69.5,700,2.7,0,0.0,7094,27.8,18424,18424,(X),3.8,12589,12589,8370,66.5,8370,66.5,7957,63.2,2755,2755,2169,78.7,5593,5593,4527,80.9
31143,4207,4207,2780,66.1,2778,66.0,2630,62.5,148,3.5,2,0.0,1427,33.9,2778,2778,(X),5.3,2144,2144,1269,59.2,1269,59.2,1179,55.0,312,312,156,50.0,888,888,682,76.8
31145,8687,8687,5915,68.1,5915,68.1,5727,65.9,188,2.2,0,0.0,2772,31.9,5915,5915,(X),3.2,4337,4337,2846,65.6,2846,65.6,2771,63.9,699,699,423,60.5,1640,1640,1371,83.6
31147,6539,6539,4152,63.5,4152,63.5,4010,61.3,142,2.2,0,0.0,2387,36.5,4152,4152,(X),3.4,3333,3333,1965,59.0,1965,59.0,1920,57.6,475,475,396,83.4,1137,1137,922,81.1
31149,1140,1140,759,66.6,755,66.2,752,66.0,3,0.3,4,0.4,381,33.4,755,755,(X),0.4,579,579,360,62.2,360,62.2,360,62.2,90,90,64,71.1,136,136,128,94.1
31151,11017,11017,7311,66.4,7311,66.4,7085,64.3,226,2.1,0,0.0,3706,33.6,7311,7311,(X),3.1,5383,5383,3224,59.9,3224,59.9,3156,58.6,1086,1086,812,74.8,2431,2431,2043,84.0
31153,134025,134025,100285,74.8,96860,72.3,93923,70.1,2937,2.2,3425,2.6,33740,25.2,96860,96860,(X),3.0,67574,67574,46916,69.4,46408,68.7,45034,66.6,15638,15638,11480,73.4,32156,32156,25872,80.5
31155,16375,16375,11223,68.5,11206,68.4,10935,66.8,271,1.7,17,0.1,5152,31.5,11206,11206,(X),2.4,8116,8116,5125,63.1,5125,63.1,5029,62.0,1637,1637,1198,73.2,3528,3528,2962,84.0
31157,28137,28137,18460,65.6,18451,65.6,17505,62.2,946,3.4,9,0.0,9677,34.4,18451,18451,(X),5.1,14736,14736,8897,60.4,8897,60.4,8455,57.4,2786,2786,2143,76.9,5711,5711,4502,78.8
31159,13574,13574,9140,67.3,9137,67.3,8947,65.9,190,1.4,3,0.0,4434,32.7,9137,9137,(X),2.1,6682,6682,4097,61.3,4097,61.3,4015,60.1,1198,1198,782,65.3,2702,2702,2004,74.2
31161,4155,4155,2679,64.5,2679,64.5,2614,62.9,65,1.6,0,0.0,1476,35.5,2679,2679,(X),2.4,2137,2137,1292,60.5,1292,60.5,1249,58.4,323,323,277,85.8,790,790,683,86.5
31163,2497,2497,1568,62.8,1564,62.6,1536,61.5,28,1.1,4,0.2,929,37.2,1564,1564,(X),1.8,1259,1259,725,57.6,725,57.6,706,56.1,189,189,109,57.7,412,412,260,63.1
31165,1008,1008,665,66.0,665,66.0,658,65.3,7,0.7,0,0.0,343,34.0,665,665,(X),1.1,529,529,311,58.8,311,58.8,309,58.4,141,141,117,83.0,120,120,97,80.8
31167,4640,4640,3290,70.9,3286,70.8,3191,68.8,95,2.0,4,0.1,1350,29.1,3286,3286,(X),2.9,2318,2318,1523,65.7,1519,65.5,1483,64.0,458,458,392,85.6,1032,1032,902,87.4
31169,4081,4081,2635,64.6,2635,64.6,2607,63.9,28,0.7,0,0.0,1446,35.4,2635,2635,(X),1.1,2068,2068,1225,59.2,1225,59.2,1212,58.6,355,355,262,73.8,738,738,652,88.3
31171,526,526,362,68.8,362,68.8,356,67.7,6,1.1,0,0.0,164,31.2,362,362,(X),1.7,270,270,165,61.1,165,61.1,165,61.1,44,44,15,34.1,80,80,73,91.3
31173,4859,4859,3103,63.9,3100,63.8,2635,54.2,465,9.6,3,0.1,1756,36.1,3100,3100,(X),15.0,2488,2488,1500,60.3,1500,60.3,1293,52.0,745,745,533,71.5,1471,1471,1119,76.1
31175,3368,3368,2253,66.9,2253,66.9,2214,65.7,39,1.2,0,0.0,1115,33.1,2253,2253,(X),1.7,1736,1736,1083,62.4,1083,62.4,1060,61.1,312,312,242,77.6,600,600,481,80.2
31177,15913,15913,10649,66.9,10634,66.8,10380,65.2,254,1.6,15,0.1,5264,33.1,10634,10634,(X),2.4,8229,8229,5181,63.0,5181,63.0,5061,61.5,1375,1375,981,71.3,3437,3437,2349,68.3
31179,7711,7711,5569,72.2,5569,72.2,5464,70.9,105,1.4,0,0.0,2142,27.8,5569,5569,(X),1.9,3868,3868,2684,69.4,2684,69.4,2601,67.2,551,551,502,91.1,1270,1270,1134,89.3
31181,2816,2816,1776,63.1,1776,63.1,1734,61.6,42,1.5,0,0.0,1040,36.9,1776,1776,(X),2.4,1404,1404,785,55.9,785,55.9,771,54.9,189,189,163,86.2,598,598,516,86.3
31183,695,695,463,66.6,463,66.6,461,66.3,2,0.3,0,0.0,232,33.4,463,463,(X),0.4,329,329,174,52.9,174,52.9,174,52.9,59,59,34,57.6,88,88,65,73.9
31185,10966,10966,7096,64.7,7096,64.7,6888,62.8,208,1.9,0,0.0,3870,35.3,7096,7096,(X),2.9,5791,5791,3331,57.5,3331,57.5,3258,56.3,1042,1042,832,79.8,1925,1925,1632,84.8
32001,19017,19017,10804,56.8,10042,52.8,9320,49.0,722,3.8,762,4.0,8213,43.2,10042,10042,(X),7.2,9368,9368,4617,49.3,4431,47.3,4124,44.0,1811,1811,1141,63.0,3398,3398,2124,62.5
32003,1692284,1692284,1088151,64.3,1081607,63.9,1003320,59.3,78287,4.6,6544,0.4,604133,35.7,1081607,1081607,(X),7.2,851417,851417,505149,59.3,504114,59.2,467749,54.9,156973,156973,103431,65.9,321085,321085,224971,70.1
32005,40551,40551,22111,54.5,22070,54.4,20933,51.6,1137,2.8,41,0.1,18440,45.5,22070,22070,(X),5.2,20207,20207,10314,51.0,10314,51.0,9876,48.9,2214,2214,1306,59.0,5843,5843,4261,72.9
32007,39395,39395,27425,69.6,27415,69.6,26171,66.4,1244,3.2,10,0.0,11970,30.4,27415,27415,(X),4.5,18758,18758,11474,61.2,11474,61.2,11030,58.8,4473,4473,2235,50.0,9245,9245,6206,67.1
32009,794,794,395,49.7,395,49.7,388,48.9,7,0.9,0,0.0,399,50.3,395,395,(X),1.8,445,445,163,36.6,163,36.6,156,35.1,43,43,11,25.6,153,153,51,33.3
32011,1456,1456,961,66.0,961,66.0,961,66.0,0,0.0,0,0.0,495,34.0,961,961,(X),0.0,684,684,396,57.9,396,57.9,396,57.9,78,78,33,42.3,327,327,225,68.8
32013,12757,12757,9023,70.7,9016,70.7,8539,66.9,477,3.7,7,0.1,3734,29.3,9016,9016,(X),5.3,6015,6015,3854,64.1,3854,64.1,3606,60.0,1378,1378,1053,76.4,3072,3072,2503,81.5
32015,4287,4287,2863,66.8,2863,66.8,2597,60.6,266,6.2,0,0.0,1424,33.2,2863,2863,(X),9.3,1961,1961,1107,56.5,1107,56.5,970,49.5,480,480,384,80.0,1152,1152,998,86.6
32017,4434,4434,1994,45.0,1994,45.0,1782,40.2,212,4.8,0,0.0,2440,55.0,1994,1994,(X),10.6,2031,2031,902,44.4,902,44.4,858,42.2,306,306,210,68.6,503,503,387,76.9
32019,42956,42956,24153,56.2,24052,56.0,21969,51.1,2083,4.8,101,0.2,18803,43.8,24052,24052,(X),8.7,21171,21171,10950,51.7,10916,51.6,9897,46.7,3617,3617,2354,65.1,6977,6977,4535,65.0
32021,3755,3755,2032,54.1,2032,54.1,1732,46.1,300,8.0,0,0.0,1723,45.9,2032,2032,(X),14.8,1894,1894,937,49.5,937,49.5,828,43.7,313,313,278,88.8,392,392,254,64.8
32023,37085,37085,16289,43.9,16289,43.9,14762,39.8,1527,4.1,0,0.0,20796,56.1,16289,16289,(X),9.4,18158,18158,7207,39.7,7207,39.7,6388,35.2,2261,2261,1006,44.5,4715,4715,2716,57.6
32027,5656,5656,2174,38.4,2174,38.4,2022,35.7,152,2.7,0,0.0,3482,61.6,2174,2174,(X),7.0,1777,1777,847,47.7,847,47.7,801,45.1,375,375,280,74.7,667,667,513,76.9
32029,3416,3416,1767,51.7,1739,50.9,1664,48.7,75,2.2,28,0.8,1649,48.3,1739,1739,(X),4.3,1643,1643,841,51.2,833,50.7,833,50.7,266,266,191,71.8,292,292,265,90.8
32031,362418,362418,239557,66.1,239148,66.0,225689,62.3,13459,3.7,409,0.1,122861,33.9,239148,239148,(X),5.6,180996,180996,110368,61.0,110173,60.9,104371,57.7,30888,30888,21325,69.0,63886,63886,46375,72.6
32033,7907,7907,3802,48.1,3802,48.1,3656,46.2,146,1.8,0,0.0,4105,51.9,3802,3802,(X),3.8,3192,3192,1598,50.1,1598,50.1,1532,48.0,569,569,246,43.2,1314,1314,899,68.4
32510,44658,44658,26781,60.0,26752,59.9,25098,56.2,1654,3.7,29,0.1,17877,40.0,26752,26752,(X),6.2,21736,21736,12335,56.7,12330,56.7,11540,53.1,3300,3300,2040,61.8,7137,7137,5575,78.1
33001,50699,50699,32486,64.1,32457,64.0,30946,61.0,1511,3.0,29,0.1,18213,35.9,32457,32457,(X),4.7,25938,25938,15859,61.1,15859,61.1,15321,59.1,3182,3182,2172,68.3,7750,7750,6106,78.8
33003,41221,41221,24559,59.6,24529,59.5,23636,57.3,893,2.2,30,0.1,16662,40.4,24529,24529,(X),3.6,20819,20819,11509,55.3,11509,55.3,11176,53.7,2140,2140,1424,66.5,5245,5245,3876,73.9
33005,64173,64173,41761,65.1,41752,65.1,40161,62.6,1591,2.5,9,0.0,22412,34.9,41752,41752,(X),3.8,33002,33002,20151,61.1,20151,61.1,19642,59.5,4185,4185,3154,75.4,8903,8903,6758,75.9
33007,27423,27423,15451,56.3,15413,56.2,14544,53.0,869,3.2,38,0.1,11972,43.7,15413,15413,(X),5.6,12895,12895,7597,58.9,7597,58.9,7332,56.9,1380,1380,1051,76.2,3442,3442,2583,75.0
33009,76790,76790,48362,63.0,48331,62.9,46707,60.8,1624,2.1,31,0.0,28428,37.0,48331,48331,(X),3.4,39295,39295,23815,60.6,23815,60.6,22960,58.4,4253,4253,3045,71.6,9682,9682,7344,75.9
33011,335710,335710,235326,70.1,234955,70.0,224741,66.9,10214,3.0,371,0.1,100384,29.9,234955,234955,(X),4.3,170015,170015,109775,64.6,109718,64.5,105605,62.1,25580,25580,17609,68.8,57624,57624,42847,74.4
33013,124014,124014,82234,66.3,82049,66.2,78874,63.6,3175,2.6,185,0.1,41780,33.7,82049,82049,(X),3.9,63450,63450,39854,62.8,39841,62.8,38221,60.2,8585,8585,6444,75.1,19187,19187,14953,77.9
33015,252426,252426,180767,71.6,179920,71.3,173214,68.6,6706,2.7,847,0.3,71659,28.4,179920,179920,(X),3.7,128299,128299,85512,66.7,85512,66.7,82718,64.5,16455,16455,12845,78.1,42793,42793,33290,77.8
33017,106617,106617,73152,68.6,72862,68.3,69879,65.5,2983,2.8,290,0.3,33465,31.4,72862,72862,(X),4.1,54858,54858,35465,64.6,35427,64.6,34005,62.0,7388,7388,4747,64.3,15529,15529,11524,74.2
33019,35744,35744,22141,61.9,22141,61.9,21315,59.6,826,2.3,0,0.0,13603,38.1,22141,22141,(X),3.7,17943,17943,10708,59.7,10708,59.7,10411,58.0,2334,2334,1528,65.5,5538,5538,4229,76.4
34001,217525,217525,141178,64.9,140914,64.8,127434,58.6,13480,6.2,264,0.1,76347,35.1,140914,140914,(X),9.6,113134,113134,69437,61.4,69385,61.3,63052,55.7,17135,17135,12469,72.8,37827,37827,30666,81.1
34003,755651,755651,498649,66.0,498438,66.0,476034,63.0,22404,3.0,211,0.0,257002,34.0,498438,498438,(X),4.5,393711,393711,233417,59.3,233352,59.3,223153,56.7,59724,59724,38100,63.8,136161,136161,96309,70.7
34005,362926,362926,242130,66.7,237787,65.5,222818,61.4,14969,4.1,4343,1.2,120796,33.3,237787,237787,(X),6.3,185555,185555,115784,62.4,115230,62.1,108294,58.4,27565,27565,19807,71.9,63669,63669,48661,76.4
34007,404141,404141,266763,66.0,266385,65.9,247509,61.2,18876,4.7,378,0.1,137378,34.0,266385,266385,(X),7.1,211972,211972,130477,61.6,130446,61.5,122037,57.6,35593,35593,26827,75.4,74993,74993,56804,75.7
34009,79298,79298,46009,58.0,45083,56.9,41593,52.5,3490,4.4,926,1.2,33289,42.0,45083,45083,(X),7.7,40883,40883,21521,52.6,21456,52.5,19863,48.6,4719,4719,3524,74.7,10735,10735,8232,76.7
34011,121197,121197,67897,56.0,67856,56.0,62928,51.9,4928,4.1,41,0.0,53300,44.0,67856,67856,(X),7.3,58682,58682,32960,56.2,32960,56.2,30890,52.6,11146,11146,7866,70.6,22800,22800,16850,73.9
34013,624970,624970,411611,65.9,411521,65.8,373790,59.8,37731,6.0,90,0.0,213359,34.1,411521,411521,(X),9.2,329123,329123,203534,61.8,203534,61.8,184411,56.0,61014,61014,45441,74.5,120293,120293,93024,77.3
34015,233759,233759,157708,67.5,157619,67.4,147707,63.2,9912,4.2,89,0.0,76051,32.5,157619,157619,(X),6.3,121854,121854,75729,62.1,75729,62.1,71249,58.5,18615,18615,13655,73.4,43921,43921,33998,77.4
34017,544263,544263,375306,69.0,375081,68.9,352378,64.7,22703,4.2,225,0.0,168957,31.0,375081,375081,(X),6.1,275064,275064,171336,62.3,171267,62.3,159472,58.0,53169,53169,34806,65.5,78962,78962,54741,69.3
34019,103664,103664,69156,66.7,69109,66.7,66375,64.0,2734,2.6,47,0.0,34508,33.3,69109,69109,(X),4.0,52096,52096,33165,63.7,33165,63.7,31912,61.3,5906,5906,4398,74.5,17911,17911,13192,73.7
34021,298866,298866,193843,64.9,193804,64.8,180710,60.5,13094,4.4,39,0.0,105023,35.1,193804,193804,(X),6.8,154084,154084,92547,60.1,92508,60.0,86323,56.0,23962,23962,16404,68.5,51885,51885,39050,75.3
34023,666635,666635,429947,64.5,429780,64.5,405537,60.8,24243,3.6,167,0.0,236688,35.5,429780,429780,(X),5.6,341098,341098,198560,58.2,198544,58.2,186989,54.8,57105,57105,36055,63.1,119320,119320,86585,72.6
34025,506127,506127,333518,65.9,333155,65.8,315831,62.4,17324,3.4,363,0.1,172609,34.1,333155,333155,(X),5.2,262818,262818,156193,59.4,156093,59.4,147950,56.3,37186,37186,24772,66.6,94266,94266,65495,69.5
34027,401885,401885,274606,68.3,274418,68.3,261479,65.1,12939,3.2,188,0.0,127279,31.7,274418,274418,(X),4.7,207071,207071,127860,61.7,127860,61.7,121296,58.6,29391,29391,20394,69.4,75756,75756,53821,71.0
34029,466075,466075,272945,58.6,272412,58.4,256360,55.0,16052,3.4,533,0.1,193130,41.4,272412,272412,(X),5.9,245468,245468,132676,54.1,132630,54.0,125414,51.1,46916,46916,27735,59.1,89280,89280,60096,67.3
34031,396321,396321,251608,63.5,251492,63.5,238879,60.3,12613,3.2,116,0.0,144713,36.5,251492,251492,(X),5.0,206025,206025,117611,57.1,117557,57.1,111508,54.1,40247,40247,23761,59.0,76915,76915,51404,66.8
34033,51320,51320,31689,61.7,31676,61.7,29352,57.2,2324,4.5,13,0.0,19631,38.3,31676,31676,(X),7.3,26542,26542,15532,58.5,15532,58.5,14390,54.2,3916,3916,2612,66.7,9063,9063,6542,72.2
34035,265127,265127,181554,68.5,181508,68.5,173381,65.4,8127,3.1,46,0.0,83573,31.5,181508,181508,(X),4.5,137266,137266,85838,62.5,85838,62.5,81924,59.7,20306,20306,12970,63.9,52078,52078,37808,72.6
34037,117248,117248,80059,68.3,80037,68.3,75439,64.3,4598,3.9,22,0.0,37189,31.7,80037,80037,(X),5.7,59391,59391,37763,63.6,37763,63.6,35708,60.1,7829,7829,4921,62.9,20536,20536,14629,71.2
34039,437481,437481,299008,68.3,298724,68.3,279881,64.0,18843,4.3,284,0.1,138473,31.7,298724,298724,(X),6.3,226649,226649,140540,62.0,140495,62.0,131486,58.0,41372,41372,29561,71.5,84853,84853,63945,75.4
34041,87696,87696,58928,67.2,58887,67.1,55187,62.9,3700,4.2,41,0.0,28768,32.8,58887,58887,(X),6.3,45117,45117,27691,61.4,27691,61.4,25943,57.5,5866,5866,4085,69.6,15272,15272,11827,77.4
35001,543534,543534,339048,62.4,336358,61.9,315193,58.0,21165,3.9,2690,0.5,204486,37.6,336358,336358,(X),6.3,279756,279756,162913,58.2,162539,58.1,152740,54.6,46223,46223,30064,65.0,97350,97350,69662,71.6
35003,3190,3190,842,26.4,842,26.4,842,26.4,0,0.0,0,0.0,2348,73.6,842,842,(X),0.0,1439,1439,343,23.8,343,23.8,343,23.8,80,80,61,76.3,209,209,103,49.3
35005,50213,50213,28353,56.5,28288,56.3,26629,53.0,1659,3.3,65,0.1,21860,43.5,28288,28288,(X),5.9,25416,25416,13043,51.3,13043,51.3,12357,48.6,5250,5250,3289,62.6,11000,11000,7111,64.6
35006,21435,21435,11293,52.7,11273,52.6,9537,44.5,1736,8.1,20,0.1,10142,47.3,11273,11273,(X),15.4,10488,10488,5467,52.1,5467,52.1,4651,44.3,1849,1849,1386,75.0,3635,3635,2652,73.0
35007,10287,10287,5223,50.8,5223,50.8,4737,46.0,486,4.7,0,0.0,5064,49.2,5223,5223,(X),9.3,5078,5078,2579,50.8,2579,50.8,2442,48.1,662,662,585,88.4,1394,1394,1013,72.7
35009,38277,38277,24543,64.1,22180,57.9,20673,54.0,1507,3.9,2363,6.2,13734,35.9,22180,22180,(X),6.8,18331,18331,10147,55.4,9839,53.7,9074,49.5,4663,4663,2439,52.3,8077,8077,5281,65.4
35011,1618,1618,776,48.0,776,48.0,748,46.2,28,1.7,0,0.0,842,52.0,776,776,(X),3.6,766,766,297,38.8,297,38.8,282,36.8,116,116,108,93.1,428,428,350,81.8
35013,167514,167514,97233,58.0,96502,57.6,88450,52.8,8052,4.8,731,0.4,70281,42.0,96502,96502,(X),8.3,86157,86157,46250,53.7,46127,53.5,42747,49.6,17054,17054,9765,57.3,34029,34029,21887,64.3
35015,43952,43952,27377,62.3,27243,62.0,26013,59.2,1230,2.8,134,0.3,16575,37.7,27243,27243,(X),4.5,21774,21774,11708,53.8,11708,53.8,11213,51.5,4472,4472,2475,55.3,9544,9544,6609,69.2
35017,22788,22788,11349,49.8,11332,49.7,10473,46.0,859,3.8,17,0.1,11439,50.2,11332,11332,(X),7.6,11719,11719,5701,48.6,5684,48.5,5375,45.9,1849,1849,1022,55.3,3832,3832,2550,66.5
35019,3691,3691,1399,37.9,1399,37.9,1311,35.5,88,2.4,0,0.0,2292,62.1,1399,1399,(X),6.3,1531,1531,746,48.7,746,48.7,687,44.9,326,326,293,89.9,436,436,330,75.7
35021,393,393,167,42.5,164,41.7,154,39.2,10,2.5,3,0.8,226,57.5,164,164,(X),6.1,131,131,60,45.8,60,45.8,59,45.0,25,25,16,64.0,39,39,36,92.3
35023,3479,3479,1741,50.0,1697,48.8,1541,44.3,156,4.5,44,1.3,1738,50.0,1697,1697,(X),9.2,1739,1739,817,47.0,817,47.0,754,43.4,234,234,71,30.3,647,647,447,69.1
35025,51075,51075,30650,60.0,30645,60.0,28674,56.1,1971,3.9,5,0.0,20425,40.0,30645,30645,(X),6.4,24799,24799,12362,49.8,12362,49.8,11553,46.6,6225,6225,3144,50.5,13892,13892,7701,55.4
35027,16493,16493,7291,44.2,7291,44.2,6979,42.3,312,1.9,0,0.0,9202,55.8,7291,7291,(X),4.3,8709,8709,3305,37.9,3305,37.9,3197,36.7,868,868,525,60.5,2400,2400,1240,51.7
35028,14644,14644,9872,67.4,9857,67.3,9516,65.0,341,2.3,15,0.1,4772,32.6,9857,9857,(X),3.5,7216,7216,4375,60.6,4367,60.5,4194,58.1,1098,1098,609,55.5,3026,3026,2229,73.7
35029,18484,18484,8703,47.1,8703,47.1,7658,41.4,1045,5.7,0,0.0,9781,52.9,8703,8703,(X),12.0,9281,9281,3955,42.6,3955,42.6,3432,37.0,2059,2059,1141,55.4,3607,3607,2422,67.1
35031,53940,53940,28027,52.0,28025,52.0,23614,43.8,4411,8.2,2,0.0,25913,48.0,28025,28025,(X),15.7,28305,28305,14366,50.8,14366,50.8,12510,44.2,6570,6570,3893,59.3,12841,12841,8468,65.9
35033,3751,3751,1510,40.3,1510,40.3,1399,37.3,111,3.0,0,0.0,2241,59.7,1510,1510,(X),7.4,1958,1958,863,44.1,863,44.1,830,42.4,255,255,127,49.8,547,547,310,56.7
35035,51975,51975,28379,54.6,25921,49.9,23841,45.9,2080,4.0,2458,4.7,23596,45.4,25921,25921,(X),8.0,25125,25125,12844,51.1,12453,49.6,11664,46.4,5360,5360,3052,56.9,8831,8831,5288,59.9
35037,6602,6602,3032,45.9,3032,45.9,2846,43.1,186,2.8,0,0.0,3570,54.1,3032,3032,(X),6.1,3515,3515,1521,43.3,1521,43.3,1486,42.3,598,598,402,67.2,1079,1079,680,63.0
35039,(X),(X),(X),(X),(X),(X),(X),(X),(X),(X),(X),(X),(X),(X),(X),(X),(X),(X),(X),(X),(X),(X),(X),(X),(X),(X),(X),(X),(X),(X),(X),(X),(X),(X)
35041,14858,14858,9119,61.4,8752,58.9,7957,53.6,795,5.4,367,2.5,5739,38.6,8752,8752,(X),9.1,7567,7567,4104,54.2,4041,53.4,3648,48.2,1854,1854,1131,61.0,2579,2579,1662,64.4
35043,111109,111109,65779,59.2,65544,59.0,60468,54.4,5076,4.6,235,0.2,45330,40.8,65544,65544,(X),7.7,57309,57309,31563,55.1,31487,54.9,29141,50.8,9041,9041,5306,58.7,22909,22909,15763,68.8
35045,96618,96618,55819,57.8,55718,57.7,50732,52.5,4986,5.2,101,0.1,40799,42.2,55718,55718,(X),8.9,49064,49064,25881,52.7,25805,52.6,23835,48.6,10228,10228,5506,53.8,21693,21693,13572,62.6
35047,23439,23439,10375,44.3,10375,44.3,9714,41.4,661,2.8,0,0.0,13064,55.7,10375,10375,(X),6.4,11786,11786,5086,43.2,5086,43.2,4891,41.5,1511,1511,890,58.9,3515,3515,2135,60.7
35049,124499,124499,74009,59.4,73951,59.4,70648,56.7,3303,2.7,58,0.0,50490,40.6,73951,73951,(X),4.5,64469,64469,35850,55.6,35846,55.6,34326,53.2,7689,7689,4643,60.4,18936,18936,13412,70.8
35051,9533,9533,4063,42.6,4063,42.6,3619,38.0,444,4.7,0,0.0,5470,57.4,4063,4063,(X),10.9,4786,4786,2019,42.2,2019,42.2,1802,37.7,521,521,273,52.4,1141,1141,884,77.5
35053,13390,13390,5857,43.7,5857,43.7,5579,41.7,278,2.1,0,0.0,7533,56.3,5857,5857,(X),4.7,6515,6515,2930,45.0,2930,45.0,2770,42.5,797,797,481,60.4,2730,2730,1961,71.8
35055,27470,27470,14925,54.3,14923,54.3,13666,49.7,1257,4.6,2,0.0,12545,45.7,14923,14923,(X),8.4,14122,14122,7749,54.9,7747,54.9,7403,52.4,1828,1828,1165,63.7,3795,3795,2598,68.5
35057,12766,12766,6028,47.2,6028,47.2,5712,44.7,316,2.5,0,0.0,6738,52.8,6028,6028,(X),5.2,5893,5893,2535,43.0,2535,43.0,2428,41.2,827,827,461,55.7,1983,1983,1099,55.4
35059,3436,3436,1613,46.9,1613,46.9,1588,46.2,25,0.7,0,0.0,1823,53.1,1613,1613,(X),1.5,1476,1476,737,49.9,737,49.9,733,49.7,305,305,116,38.0,462,462,272,58.9
35061,60135,60135,31848,53.0,31705,52.7,29040,48.3,2665,4.4,143,0.2,28287,47.0,31705,31705,(X),8.4,30216,30216,14876,49.2,14864,49.2,13552,44.9,4798,4798,2865,59.7,12219,12219,7413,60.7
36001,257077,257077,168148,65.4,167879,65.3,159756,62.1,8123,3.2,269,0.1,88929,34.6,167879,167879,(X),4.8,133840,133840,83346,62.3,83315,62.2,79686,59.5,17671,17671,13506,76.4,37023,37023,29676,80.2
36003,38593,38593,21334,55.3,21325,55.3,20029,51.9,1296,3.4,9,0.0,17259,44.7,21325,21325,(X),6.1,19180,19180,10119,52.8,10119,52.8,9705,50.6,2861,2861,1753,61.3,6034,6034,4208,69.7
36005,1115770,1115770,666195,59.7,665907,59.7,595657,53.4,70250,6.3,288,0.0,449575,40.3,665907,665907,(X),10.5,602950,602950,335099,55.6,335063,55.6,300300,49.8,118405,118405,78651,66.4,221259,221259,150925,68.2
36007,161174,161174,93394,57.9,93347,57.9,87190,54.1,6157,3.8,47,0.0,67780,42.1,93347,93347,(X),6.6,82979,82979,44597,53.7,44586,53.7,42154,50.8,11555,11555,7844,67.9,23786,23786,16429,69.1
36009,62339,62339,35920,57.6,35878,57.6,33610,53.9,2268,3.6,42,0.1,26419,42.4,35878,35878,(X),6.3,31654,31654,17196,54.3,17196,54.3,16233,51.3,5199,5199,3310,63.7,10964,10964,7878,71.9
36011,64367,64367,38590,60.0,38573,59.9,36489,56.7,2084,3.2,17,0.0,25777,40.0,38573,38573,(X),5.4,31392,31392,18458,58.8,18458,58.8,17609,56.1,4512,4512,3166,70.2,10006,10006,7752,77.5
36013,106146,106146,60185,56.7,60147,56.7,56021,52.8,4126,3.9,38,0.0,45961,43.3,60147,60147,(X),6.9,54009,54009,28745,53.2,28736,53.2,27037,50.1,8207,8207,5141,62.6,17175,17175,11515,67.0
36015,69181,69181,39260,56.7,39242,56.7,37261,53.9,1981,2.9,18,0.0,29921,43.3,39242,39242,(X),5.0,35197,35197,19188,54.5,19188,54.5,18356,52.2,5616,5616,3740,66.6,11647,11647,8030,68.9
36017,39486,39486,23263,58.9,23229,58.8,21902,55.5,1327,3.4,34,0.1,16223,41.1,23229,23229,(X),5.7,19853,19853,10980,55.3,10980,55.3,10453,52.7,3060,3060,2317,75.7,6223,6223,4425,71.1
36019,67919,67919,37903,55.8,37869,55.8,36060,53.1,1809,2.7,34,0.1,30016,44.2,37869,37869,(X),4.8,33008,33008,18153,55.0,18153,55.0,17217,52.2,4353,4353,3064,70.4,9229,9229,7012,76.0
36021,51451,51451,31096,60.4,31082,60.4,29545,57.4,1537,3.0,14,0.0,20355,39.6,31082,31082,(X),4.9,25811,25811,14858,57.6,14858,57.6,14155,54.8,2920,2920,1980,67.8,7118,7118,5289,74.3
36023,39880,39880,24648,61.8,24638,61.8,23525,59.0,1113,2.8,10,0.0,15232,38.2,24638,24638,(X),4.5,20576,20576,12047,58.5,12047,58.5,11644,56.6,2936,2936,2284,77.8,5953,5953,4750,79.8
36025,38904,38904,21304,54.8,21301,54.8,20204,51.9,1097,2.8,3,0.0,17600,45.2,21301,21301,(X),5.1,19297,19297,9869,51.1,9869,51.1,9391,48.7,2055,2055,1555,75.7,5162,5162,3529,68.4
36027,244486,244486,153137,62.6,153039,62.6,144058,58.9,8981,3.7,98,0.0,91349,37.4,153039,153039,(X),5.9,123400,123400,73442,59.5,73442,59.5,69436,56.3,16082,16082,11138,69.3,38055,38055,26997,70.9
36029,754647,754647,472206,62.6,471692,62.5,449109,59.5,22583,3.0,514,0.1,282441,37.4,471692,471692,(X),4.8,393762,393762,232115,58.9,232023,58.9,222187,56.4,57554,57554,39197,68.1,122321,122321,88766,72.6
36031,32344,32344,18378,56.8,18366,56.8,17294,53.5,1072,3.3,12,0.0,13966,43.2,18366,18366,(X),5.8,15511,15511,9125,58.8,9125,58.8,8687,56.0,1897,1897,1470,77.5,4070,4070,3302,81.1
36033,41826,41826,21765,52.0,21748,52.0,20209,48.3,1539,3.7,17,0.0,20061,48.0,21748,21748,(X),7.1,18648,18648,10273,55.1,10273,55.1,9460,50.7,2924,2924,1979,67.7,6361,6361,4690,73.7
36035,44067,44067,25946,58.9,25934,58.9,24360,55.3,1574,3.6,12,0.0,18121,41.1,25934,25934,(X),6.1,22198,22198,12040,54.2,12040,54.2,11394,51.3,3094,3094,2327,75.2,6957,6957,4985,71.7
36037,47724,47724,31368,65.7,31365,65.7,29897,62.6,1468,3.1,3,0.0,16356,34.3,31365,31365,(X),4.7,23897,23897,15088,63.1,15088,63.1,14336,60.0,3457,3457,2531,73.2,7700,7700,5809,75.4
36039,40586,40586,21303,52.5,21273,52.4,20292,50.0,981,2.4,30,0.1,19283,47.5,21273,21273,(X),4.6,19277,19277,9996,51.9,9996,51.9,9636,50.0,2325,2325,1422,61.2,4978,4978,3258,65.4
36041,4023,4023,2120,52.7,2116,52.6,1946,48.4,170,4.2,4,0.1,1903,47.3,2116,2116,(X),8.0,1948,1948,892,45.8,892,45.8,796,40.9,157,157,124,79.0,423,423,350,82.7
36043,51099,51099,30898,60.5,30834,60.3,28627,56.0,2207,4.3,64,0.1,20201,39.5,30834,30834,(X),7.2,26026,26026,14757,56.7,14757,56.7,13772,52.9,3717,3717,2454,66.0,8606,8606,5846,67.9
36045,89445,89445,57586,64.4,47853,53.5,44760,50.0,3093,3.5,9733,10.9,31859,35.6,47853,47853,(X),6.5,42130,42130,24193,57.4,23390,55.5,21776,51.7,10295,10295,5680,55.2,16198,16198,11089,68.5
36047,2061526,2061526,1309854,63.5,1309155,63.5,1217624,59.1,91531,4.4,699,0.0,751672,36.5,1309155,1309155,(X),7.0,1104985,1104985,654046,59.2,653846,59.2,611009,55.3,218031,218031,133328,61.2,353683,353683,232023,65.6
36049,21154,21154,12752,60.3,12583,59.5,11711,55.4,872,4.1,169,0.8,8402,39.7,12583,12583,(X),6.9,10470,10470,5661,54.1,5640,53.9,5343,51.0,1888,1888,1168,61.9,3969,3969,2514,63.3
36051,53897,53897,30093,55.8,30079,55.8,28822,53.5,1257,2.3,14,0.0,23804,44.2,30079,30079,(X),4.2,26938,26938,14735,54.7,14735,54.7,14241,52.9,3186,3186,2088,65.5,7664,7664,6027,78.6
36053,59311,59311,35418,59.7,35367,59.6,33712,56.8,1655,2.8,51,0.1,23893,40.3,35367,35367,(X),4.7,30278,30278,16811,55.5,16811,55.5,15958,52.7,3890,3890,2715,69.8,9494,9494,6828,71.9
36055,605112,605112,390194,64.5,390058,64.5,367045,60.7,23013,3.8,136,0.0,214918,35.5,390058,390058,(X),5.9,316582,316582,192721,60.9,192713,60.9,182549,57.7,48877,48877,35468,72.6,102437,102437,78050,76.2
36057,39377,39377,23357,59.3,23337,59.3,21536,54.7,1801,4.6,20,0.1,16020,40.7,23337,23337,(X),7.7,20277,20277,11337,55.9,11337,55.9,10533,51.9,3652,3652,2201,60.3,7107,7107,4958,69.8
36059,1098579,1098579,715209,65.1,714628,65.1,684098,62.3,30530,2.8,581,0.1,383370,34.9,714628,714628,(X),4.3,571474,571474,338342,59.2,338289,59.2,323797,56.7,87882,87882,62540,71.2,197916,197916,143321,72.4
36061,1419185,1419185,951766,67.1,951338,67.0,897040,63.2,54298,3.8,428,0.0,467419,32.9,951338,951338,(X),5.7,754472,754472,471887,62.5,471778,62.5,445300,59.0,89428,89428,59264,66.3,134597,134597,90516,67.2
36063,174356,174356,106548,61.1,106318,61.0,100682,57.7,5636,3.2,230,0.1,67808,38.9,106318,106318,(X),5.3,90011,90011,51784,57.5,51761,57.5,49528,55.0,12465,12465,9180,73.6,28443,28443,22110,77.7
36065,187123,187123,108640,58.1,108266,57.9,102319,54.7,5947,3.2,374,0.2,78483,41.9,108266,108266,(X),5.5,94476,94476,52186,55.2,52165,55.2,49590,52.5,15081,15081,10448,69.3,31479,31479,22113,70.2
36067,376244,376244,235381,62.6,234997,62.5,220979,58.7,14018,3.7,384,0.1,140863,37.4,234997,234997,(X),6.0,197264,197264,115421,58.5,115354,58.5,108998,55.3,30884,30884,21131,68.4,63521,63521,47934,75.5
36069,89648,89648,56731,63.3,56678,63.2,54358,60.6,2320,2.6,53,0.1,32917,36.7,56678,56678,(X),4.1,46226,46226,27457,59.4,27438,59.4,26378,57.1,6203,6203,4416,71.2,15519,15519,11634,75.0
36071,292565,292565,187618,64.1,183891,62.9,174834,59.8,9057,3.1,3727,1.3,104947,35.9,183891,183891,(X),4.9,147144,147144,87071,59.2,86481,58.8,82204,55.9,29433,29433,16839,57.2,63515,63515,41601,65.5
36073,34052,34052,19160,56.3,19160,56.3,18161,53.3,999,2.9,0,0.0,14892,43.7,19160,19160,(X),5.2,17115,17115,8846,51.7,8846,51.7,8495,49.6,2546,2546,1702,66.8,5122,5122,3601,70.3
36075,96871,96871,58045,59.9,57908,59.8,53360,55.1,4548,4.7,137,0.1,38826,40.1,57908,57908,(X),7.9,48747,48747,27269,55.9,27269,55.9,25274,51.8,7546,7546,5011,66.4,15938,15938,11058,69.4
36077,51668,51668,30110,58.3,30101,58.3,28171,54.5,1930,3.7,9,0.0,21558,41.7,30101,30101,(X),6.4,26951,26951,15069,55.9,15060,55.9,14274,53.0,2972,2972,2127,71.6,6277,6277,5007,79.8
36079,81721,81721,53932,66.0,53932,66.0,51066,62.5,2866,3.5,0,0.0,27789,34.0,53932,53932,(X),5.3,41282,41282,25686,62.2,25686,62.2,24545,59.5,5207,5207,3915,75.2,14550,14550,11148,76.6
36081,1881732,1881732,1206521,64.1,1205909,64.1,1131527,60.1,74382,4.0,612,0.0,675211,35.9,1205909,1205909,(X),6.2,980659,980659,564485,57.6,564378,57.6,528904,53.9,162184,162184,101998,62.9,281541,281541,192345,68.3
36083,131319,131319,85529,65.1,85360,65.0,81001,61.7,4359,3.3,169,0.1,45790,34.9,85360,85360,(X),5.1,66968,66968,40609,60.6,40590,60.6,38776,57.9,10045,10045,7271,72.4,20376,20376,15783,77.5
36085,382147,382147,222440,58.2,222165,58.1,211293,55.3,10872,2.8,275,0.1,159707,41.8,222165,222165,(X),4.9,199598,199598,105359,52.8,105299,52.8,100753,50.5,31900,31900,18078,56.7,69186,69186,43019,62.2
36087,243191,243191,157093,64.6,157009,64.6,148410,61.0,8599,3.5,84,0.0,86098,35.4,157009,157009,(X),5.5,125452,125452,74058,59.0,74009,59.0,70387,56.1,29438,29438,17113,58.1,58486,58486,36476,62.4
36089,89768,89768,47992,53.5,47838,53.3,44275,49.3,3563,4.0,154,0.2,41776,46.5,47838,47838,(X),7.4,44211,44211,23237,52.6,23237,52.6,21688,49.1,6676,6676,4363,65.4,14107,14107,10794,76.5
36091,186630,186630,125097,67.0,123573,66.2,118824,63.7,4749,2.5,1524,0.8,61533,33.0,123573,123573,(X),3.8,94933,94933,58190,61.3,58071,61.2,56054,59.0,13991,13991,9808,70.1,31112,31112,23398,75.2
36093,125412,125412,78915,62.9,78761,62.8,73563,58.7,5198,4.1,154,0.1,46497,37.1,78761,78761,(X),6.6,65128,65128,39503,60.7,39493,60.6,36916,56.7,10269,10269,7375,71.8,21717,21717,16881,77.7
36095,26508,26508,15390,58.1,15380,58.0,14488,54.7,892,3.4,10,0.0,11118,41.9,15380,15380,(X),5.8,13349,13349,7519,56.3,7519,56.3,7066,52.9,1615,1615,1167,72.3,3548,3548,2867,80.8
36097,14948,14948,8893,59.5,8889,59.5,8397,56.2,492,3.3,4,0.0,6055,40.5,8889,8889,(X),5.5,7549,7549,4162,55.1,4162,55.1,3979,52.7,1011,1011,756,74.8,2224,2224,1615,72.6
36099,28558,28558,16136,56.5,16136,56.5,15571,54.5,565,2.0,0,0.0,12422,43.5,16136,16136,(X),3.5,13607,13607,7729,56.8,7729,56.8,7546,55.5,2142,2142,1333,62.2,4396,4396,2686,61.1
36101,78331,78331,46022,58.8,45989,58.7,42997,54.9,2992,3.8,33,0.0,32309,41.2,45989,45989,(X),6.5,39533,39533,21547,54.5,21530,54.5,20328,51.4,6181,6181,3887,62.9,13642,13642,9824,72.0
36103,1206115,1206115,782446,64.9,781705,64.8,744693,61.7,37012,3.1,741,0.1,423669,35.1,781705,781705,(X),4.7,617854,617854,366669,59.3,366540,59.3,350364,56.7,90284,90284,61927,68.6,216483,216483,155368,71.8
36105,61202,61202,35615,58.2,35603,58.2,32846,53.7,2757,4.5,12,0.0,25587,41.8,35603,35603,(X),7.7,29874,29874,16973,56.8,16973,56.8,15913,53.3,4792,4792,3084,64.4,10339,10339,7232,69.9
36107,39894,39894,24634,61.7,24622,61.7,23065,57.8,1557,3.9,12,0.0,15260,38.3,24622,24622,(X),6.3,20349,20349,11579,56.9,11579,56.9,11035,54.2,2959,2959,1918,64.8,7050,7050,5190,73.6
36109,89418,89418,52688,58.9,52688,58.9,50250,56.2,2438,2.7,0,0.0,36730,41.1,52688,52688,(X),4.6,45722,45722,25920,56.7,25920,56.7,24966,54.6,4733,4733,3128,66.1,9382,9382,7818,83.3
36111,150935,150935,92559,61.3,92456,61.3,86733,57.5,5723,3.8,103,0.1,58376,38.7,92456,92456,(X),6.2,76371,76371,45782,59.9,45758,59.9,43376,56.8,9273,9273,6748,72.8,21081,21081,15821,75.0
36113,54214,54214,33456,61.7,33416,61.6,31937,58.9,1479,2.7,40,0.1,20758,38.3,33416,33416,(X),4.4,27842,27842,16011,57.5,16011,57.5,15396,55.3,3411,3411,2431,71.3,7598,7598,6009,79.1
36115,51390,51390,30293,58.9,30266,58.9,28537,55.5,1729,3.4,27,0.1,21097,41.1,30266,30266,(X),5.7,24857,24857,14360,57.8,14360,57.8,13584,54.6,3298,3298,2669,80.9,7539,7539,5297,70.3
36117,73471,73471,46573,63.4,46512,63.3,43779,59.6,2733,3.7,61,0.1,26898,36.6,46512,46512,(X),5.9,37267,37267,21724,58.3,21709,58.3,20631,55.4,5618,5618,4001,71.2,12810,12810,9910,77.4
36119,778474,778474,509611,65.5,509497,65.4,479775,61.6,29722,3.8,114,0.0,268863,34.5,509497,509497,(X),5.8,407777,407777,242717,59.5,242717,59.5,228641,56.1,65187,65187,45642,70.0,144647,144647,102362,70.8
36121,33373,33373,19726,59.1,19719,59.1,18562,55.6,1157,3.5,7,0.0,13647,40.9,19719,19719,(X),5.9,15230,15230,9050,59.4,9050,59.4,8698,57.1,2313,2313,1657,71.6,5242,5242,3878,74.0
36123,20044,20044,11754,58.6,11733,58.5,11181,55.8,552,2.8,21,0.1,8290,41.4,11733,11733,(X),4.7,10555,10555,5679,53.8,5662,53.6,5390,51.1,1721,1721,735,42.7,3728,3728,1991,53.4
37001,128498,128498,80236,62.4,80141,62.4,75612,58.8,4529,3.5,95,0.1,48262,37.6,80141,80141,(X),5.7,68753,68753,39661,57.7,39644,57.7,37414,54.4,11051,11051,7407,67.0,23255,23255,17562,75.5
37003,30473,30473,17434,57.2,17434,57.2,16264,53.4,1170,3.8,0,0.0,13039,42.8,17434,17434,(X),6.7,14909,14909,7998,53.6,7998,53.6,7484,50.2,2083,2083,1365,65.5,4993,4993,3543,71.0
37005,9319,9319,4839,51.9,4839,51.9,4555,48.9,284,3.0,0,0.0,4480,48.1,4839,4839,(X),5.9,4727,4727,2166,45.8,2166,45.8,2001,42.3,550,550,338,61.5,1281,1281,1011,78.9
37007,20986,20986,11493,54.8,11493,54.8,10354,49.3,1139,5.4,0,0.0,9493,45.2,11493,11493,(X),9.9,9809,9809,5311,54.1,5311,54.1,4652,47.4,1403,1403,962,68.6,3192,3192,2329,73.0
37009,22515,22515,13072,58.1,13044,57.9,12440,55.3,604,2.7,28,0.1,9443,41.9,13044,13044,(X),4.6,11522,11522,6251,54.3,6251,54.3,6016,52.2,1345,1345,1007,74.9,3108,3108,2137,68.8
37011,15221,15221,7028,46.2,7018,46.1,6718,44.1,300,2.0,10,0.1,8193,53.8,7018,7018,(X),4.3,6878,6878,3352,48.7,3352,48.7,3206,46.6,760,760,540,71.1,1767,1767,1228,69.5
37013,38636,38636,20713,53.6,20706,53.6,18867,48.8,1839,4.8,7,0.0,17923,46.4,20706,20706,(X),8.9,20419,20419,10127,49.6,10127,49.6,9201,45.1,2622,2622,2002,76.4,6101,6101,4538,74.4
37015,16533,16533,8486,51.3,8486,51.3,7496,45.3,990,6.0,0,0.0,8047,48.7,8486,8486,(X),11.7,8247,8247,4149,50.3,4149,50.3,3701,44.9,875,875,645,73.7,2290,2290,1894,82.7
37017,27443,27443,13783,50.2,13783,50.2,12805,46.7,978,3.6,0,0.0,13660,49.8,13783,13783,(X),7.1,14542,14542,6761,46.5,6761,46.5,6251,43.0,2004,2004,1247,62.2,4558,4558,2856,62.7
37019,108647,108647,54326,50.0,54223,49.9,50793,46.8,3430,3.2,103,0.1,54321,50.0,54223,54223,(X),6.3,57002,57002,26261,46.1,26261,46.1,24464,42.9,5868,5868,4156,70.8,12861,12861,9491,73.8
37021,211459,211459,130321,61.6,130047,61.5,124844,59.0,5203,2.5,274,0.1,81138,38.4,130047,130047,(X),4.0,111643,111643,63705,57.1,63638,57.0,61007,54.6,14924,14924,9831,65.9,30768,30768,21992,71.5
37023,74592,74592,42058,56.4,42012,56.3,38284,51.3,3728,5.0,46,0.1,32534,43.6,42012,42012,(X),8.9,37614,37614,20118,53.5,20118,53.5,18594,49.4,4749,4749,3180,67.0,11170,11170,8032,71.9
37025,155253,155253,106028,68.3,105902,68.2,99553,64.1,6349,4.1,126,0.1,49225,31.7,105902,105902,(X),6.0,80808,80808,50388,62.4,50388,62.4,47022,58.2,15100,15100,11208,74.2,34989,34989,26869,76.8
37027,66952,66952,38821,58.0,38821,58.0,36275,54.2,2546,3.8,0,0.0,28131,42.0,38821,38821,(X),6.6,34118,34118,17953,52.6,17953,52.6,16768,49.1,4621,4621,2972,64.3,10828,10828,7879,72.8
37029,8185,8185,5077,62.0,4933,60.3,4473,54.6,460,5.6,144,1.8,3108,38.0,4933,4933,(X),9.3,4136,4136,2253,54.5,2253,54.5,2079,50.3,561,561,349,62.2,1743,1743,1160,66.6
37031,58076,58076,33446,57.6,32757,56.4,30598,52.7,2159,3.7,689,1.2,24630,42.4,32757,32757,(X),6.6,29890,29890,15935,53.3,15816,52.9,14756,49.4,3362,3362,2479,73.7,8305,8305,6112,73.6
37033,18881,18881,10247,54.3,10247,54.3,9549,50.6,698,3.7,0,0.0,8634,45.7,10247,10247,(X),6.8,9388,9388,4891,52.1,4891,52.1,4633,49.4,1275,1275,668,52.4,2758,2758,1723,62.5
37035,125800,125800,78521,62.4,78455,62.4,73002,58.0,5453,4.3,66,0.1,47279,37.6,78455,78455,(X),7.0,64971,64971,36953,56.9,36944,56.9,34341,52.9,10014,10014,7099,70.9,23295,23295,17203,73.8
37037,57251,57251,33248,58.1,33230,58.0,31532,55.1,1698,3.0,18,0.0,24003,41.9,33230,33230,(X),5.1,30002,30002,15661,52.2,15661,52.2,14987,50.0,4107,4107,2546,62.0,9477,9477,7007,73.9
37039,23432,23432,11002,47.0,11002,47.0,10300,44.0,702,3.0,0,0.0,12430,53.0,11002,11002,(X),6.4,12087,12087,5421,44.8,5421,44.8,5206,43.1,1238,1238,819,66.2,3155,3155,2105,66.7
37041,11660,11660,6048,51.9,6015,51.6,5351,45.9,664,5.7,33,0.3,5612,48.1,6015,6015,(X),11.0,6239,6239,2674,42.9,2674,42.9,2473,39.6,698,698,276,39.5,1953,1953,1425,73.0
37043,9044,9044,4496,49.7,4496,49.7,4391,48.6,105,1.2,0,0.0,4548,50.3,4496,4496,(X),2.3,4778,4778,2001,41.9,2001,41.9,1940,40.6,536,536,397,74.1,1133,1133,737,65.0
37045,78454,78454,43742,55.8,43705,55.7,39701,50.6,4004,5.1,37,0.0,34712,44.2,43705,43705,(X),9.2,41203,41203,21409,52.0,21404,51.9,19338,46.9,6160,6160,3983,64.7,13634,13634,9655,70.8
37047,45503,45503,21264,46.7,21227,46.6,19740,43.4,1487,3.3,37,0.1,24239,53.3,21227,21227,(X),7.0,23055,23055,10724,46.5,10704,46.4,9990,43.3,3413,3413,1892,55.4,7517,7517,5078,67.6
37049,82691,82691,50689,61.3,44019,53.2,40506,49.0,3513,4.2,6670,8.1,32002,38.7,44019,44019,(X),8.0,40734,40734,21419,52.6,21085,51.8,19354,47.5,7977,7977,4388,55.0,13216,13216,8838,66.9
37051,258085,258085,166848,64.6,138439,53.6,125926,48.8,12513,4.8,28409,11.0,91237,35.4,138439,138439,(X),9.0,130390,130390,75111,57.6,71826,55.1,65304,50.1,29010,29010,17185,59.2,48377,48377,32870,67.9
37053,20662,20662,12936,62.6,12633,61.1,12025,58.2,608,2.9,303,1.5,7726,37.4,12633,12633,(X),4.8,10437,10437,5786,55.4,5756,55.1,5434,52.1,1662,1662,884,53.2,3882,3882,2433,62.7
37055,29589,29589,19155,64.7,19054,64.4,18054,61.0,1000,3.4,101,0.3,10434,35.3,19054,19054,(X),5.2,15048,15048,9216,61.2,9203,61.2,8840,58.7,1965,1965,1289,65.6,4672,4672,3619,77.5
37057,132344,132344,80022,60.5,79919,60.4,74174,56.0,5745,4.3,103,0.1,52322,39.5,79919,79919,(X),7.2,68466,68466,37288,54.5,37288,54.5,34431,50.3,10107,10107,7054,69.8,24119,24119,16751,69.5
37059,34277,34277,20421,59.6,20409,59.5,19284,56.3,1125,3.3,12,0.0,13856,40.4,20409,20409,(X),5.5,17804,17804,9605,53.9,9605,53.9,9122,51.2,2401,2401,1617,67.3,6253,6253,4286,68.5
37061,46257,46257,26949,58.3,26866,58.1,24447,52.9,2419,5.2,83,0.2,19308,41.7,26866,26866,(X),9.0,24045,24045,12317,51.2,12317,51.2,11277,46.9,3997,3997,2553,63.9,8835,8835,5997,67.9
37063,247146,247146,167297,67.7,167049,67.6,158434,64.1,8615,3.5,248,0.1,79849,32.3,167049,167049,(X),5.2,130747,130747,85309,65.2,85269,65.2,80911,61.9,23752,23752,17301,72.8,38270,38270,29813,77.9
37065,42632,42632,23641,55.5,23641,55.5,21773,51.1,1868,4.4,0,0.0,18991,44.5,23641,23641,(X),7.9,23359,23359,12212,52.3,12212,52.3,11511,49.3,3602,3602,2321,64.4,7685,7685,5863,76.3
37067,294840,294840,181746,61.6,181302,61.5,169738,57.6,11564,3.9,444,0.2,113094,38.4,181302,181302,(X),6.4,157632,157632,89736,56.9,89649,56.9,83701,53.1,26732,26732,17702,66.2,56764,56764,40010,70.5
37069,52103,52103,31562,60.6,31541,60.5,29810,57.2,1731,3.3,21,0.0,20541,39.4,31541,31541,(X),5.5,26371,26371,14771,56.0,14771,56.0,13976,53.0,4171,4171,2350,56.3,9624,9624,6009,62.4
37071,173080,173080,106115,61.3,106027,61.3,98902,57.1,7125,4.1,88,0.1,66965,38.7,106027,106027,(X),6.7,90868,90868,50699,55.8,50699,55.8,47153,51.9,14804,14804,10171,68.7,31456,31456,22532,71.6
37073,9468,9468,5594,59.1,5571,58.8,5190,54.8,381,4.0,23,0.2,3874,40.9,5571,5571,(X),6.8,4910,4910,2680,54.6,2675,54.5,2543,51.8,534,534,424,79.4,1645,1645,1198,72.8
37075,7031,7031,3416,48.6,3416,48.6,3180,45.2,236,3.4,0,0.0,3615,51.4,3416,3416,(X),6.9,3624,3624,1492,41.2,1492,41.2,1383,38.2,351,351,205,58.4,1130,1130,839,74.2
37077,48158,48158,27994,58.1,27980,58.1,26285,54.6,1695,3.5,14,0.0,20164,41.9,27980,27980,(X),6.1,23652,23652,13661,57.8,13661,57.8,12892,54.5,3419,3419,2478,72.5,8215,8215,6373,77.6
37079,17121,17121,8981,52.5,8948,52.3,8077,47.2,871,5.1,33,0.2,8140,47.5,8948,8948,(X),9.7,7611,7611,3939,51.8,3939,51.8,3552,46.7,1263,1263,823,65.2,2879,2879,1933,67.1
37081,419915,419915,266387,63.4,266134,63.4,250123,59.6,16011,3.8,253,0.1,153528,36.6,266134,266134,(X),6.0,224553,224553,131876,58.7,131845,58.7,123552,55.0,36382,36382,24882,68.4,75358,75358,54782,72.7
37083,41892,41892,21288,50.8,21288,50.8,19437,46.4,1851,4.4,0,0.0,20604,49.2,21288,21288,(X),8.7,22068,22068,10818,49.0,10818,49.0,10161,46.0,3062,3062,2249,73.4,7209,7209,5145,71.4
37085,99012,99012,59423,60.0,55073,55.6,50735,51.2,4338,4.4,4350,4.4,39589,40.0,55073,55073,(X),7.9,50528,50528,27467,54.4,27111,53.7,25031,49.5,11371,11371,5939,52.2,21563,21563,13640,63.3
37087,50872,50872,27917,54.9,27879,54.8,26560,52.2,1319,2.6,38,0.1,22955,45.1,27879,27879,(X),4.7,26621,26621,13241,49.7,13219,49.7,12673,47.6,3286,3286,2011,61.2,6840,6840,4513,66.0
37089,94241,94241,53384,56.6,53364,56.6,51829,55.0,1535,1.6,20,0.0,40857,43.4,53364,53364,(X),2.9,49488,49488,25274,51.1,25274,51.1,24591,49.7,6673,6673,4110,61.6,14268,14268,10361,72.6
37091,20073,20073,10474,52.2,10428,52.0,9283,46.2,1145,5.7,46,0.2,9599,47.8,10428,10428,(X),11.0,10238,10238,5414,52.9,5414,52.9,4831,47.2,1181,1181,988,83.7,3083,3083,2354,76.4
37093,39788,39788,23557,59.2,20849,52.4,18961,47.7,1888,4.7,2708,6.8,16231,40.8,20849,20849,(X),9.1,20455,20455,11211,54.8,10959,53.6,9978,48.8,5076,5076,2768,54.5,9033,9033,5532,61.2
37095,4332,4332,2215,51.1,2215,51.1,1984,45.8,231,5.3,0,0.0,2117,48.9,2215,2215,(X),10.4,1988,1988,1060,53.3,1060,53.3,864,43.5,327,327,205,62.7,768,768,618,80.5
37097,137060,137060,88822,64.8,88727,64.7,83378,60.8,5349,3.9,95,0.1,48238,35.2,88727,88727,(X),6.0,70372,70372,40413,57.4,40393,57.4,37706,53.6,10544,10544,7004,66.4,27535,27535,19191,69.7
37099,35861,35861,19551,54.5,19540,54.5,18614,51.9,926,2.6,11,0.0,16310,45.5,19540,19540,(X),4.7,18481,18481,9466,51.2,9466,51.2,8939,48.4,2079,2079,1362,65.5,4656,4656,3156,67.8
37101,146789,146789,94915,64.7,94669,64.5,89484,61.0,5185,3.5,246,0.2,51874,35.3,94669,94669,(X),5.5,75583,75583,45409,60.1,45309,59.9,42959,56.8,14197,14197,9226,65.0,32793,32793,24171,73.7
37103,8099,8099,4306,53.2,4272,52.7,3891,48.0,381,4.7,34,0.4,3793,46.8,4272,4272,(X),8.9,4231,4231,1961,46.3,1948,46.0,1780,42.1,479,479,328,68.5,1190,1190,754,63.4
37105,46838,46838,29089,62.1,28809,61.5,26541,56.7,2268,4.8,280,0.6,17749,37.9,28809,28809,(X),7.9,24350,24350,13721,56.3,13721,56.3,12514,51.4,4315,4315,3102,71.9,9801,9801,7038,71.8
37107,45879,45879,26735,58.3,26652,58.1,23378,51.0,3274,7.1,83,0.2,19144,41.7,26652,26652,(X),12.3,24273,24273,12664,52.2,12664,52.2,10866,44.8,3932,3932,2666,67.8,7881,7881,5696,72.3
37109,66051,66051,40684,61.6,40684,61.6,38100,57.7,2584,3.9,0,0.0,25367,38.4,40684,40684,(X),6.4,33600,33600,18484,55.0,18484,55.0,17265,51.4,4844,4844,3160,65.2,11423,11423,8308,72.7
37111,37058,37058,19853,53.6,19817,53.5,18674,50.4,1143,3.1,36,0.1,17205,46.4,19817,19817,(X),5.8,18788,18788,9331,49.7,9319,49.6,8849,47.1,2229,2229,1755,78.7,6281,6281,4581,72.9
37113,28732,28732,14618,50.9,14605,50.8,13955,48.6,650,2.3,13,0.0,14114,49.1,14605,14605,(X),4.5,15054,15054,6717,44.6,6717,44.6,6336,42.1,2075,2075,1119,53.9,3935,3935,2377,60.4
37115,17910,17910,10084,56.3,10070,56.2,9511,53.1,559,3.1,14,0.1,7826,43.7,10070,10070,(X),5.6,9180,9180,4798,52.3,4798,52.3,4574,49.8,1041,1041,671,64.5,2491,2491,1565,62.8
37117,18896,18896,10415,55.1,10391,55.0,9257,49.0,1134,6.0,24,0.1,8481,44.9,10391,10391,(X),10.9,10177,10177,5241,51.5,5241,51.5,4499,44.2,1400,1400,1023,73.1,3139,3139,2404,76.6
37119,827113,827113,588800,71.2,588213,71.1,554107,67.0,34106,4.1,587,0.1,238313,28.8,588213,588213,(X),5.8,435477,435477,285514,65.6,285389,65.5,267228,61.4,83470,83470,57219,68.6,161358,161358,119512,74.1
37121,12634,12634,6544,51.8,6534,51.7,6254,49.5,280,2.2,10,0.1,6090,48.2,6534,6534,(X),4.3,6458,6458,2873,44.5,2873,44.5,2735,42.4,822,822,499,60.7,1675,1675,1310,78.2
37123,21798,21798,11113,51.0,11078,50.8,10551,48.4,527,2.4,35,0.2,10685,49.0,11078,11078,(X),4.8,11162,11162,5431,48.7,5417,48.5,5096,45.7,1832,1832,1040,56.8,3928,3928,2376,60.5
37125,77525,77525,44253,57.1,42179,54.4,39935,51.5,2244,2.9,2074,2.7,33272,42.9,42179,42179,(X),5.3,40749,40749,21132,51.9,20912,51.3,19869,48.8,6509,6509,3757,57.7,12851,12851,8958,69.7
37127,75593,75593,46259,61.2,46235,61.2,43343,57.3,2892,3.8,24,0.0,29334,38.8,46235,46235,(X),6.3,39925,39925,23259,58.3,23259,58.3,22062,55.3,6008,6008,4544,75.6,13937,13937,10785,77.4
37129,186559,186559,116715,62.6,116158,62.3,109010,58.4,7148,3.8,557,0.3,69844,37.4,116158,116158,(X),6.2,98513,98513,58270,59.1,58255,59.1,54620,55.4,12939,12939,8770,67.8,27193,27193,19096,70.2
37131,16884,16884,7774,46.0,7774,46.0,7233,42.8,541,3.2,0,0.0,9110,54.0,7774,7774,(X),7.0,8784,8784,3833,43.6,3833,43.6,3570,40.6,1071,1071,748,69.8,2174,2174,1416,65.1
37133,150702,150702,107156,71.1,69930,46.4,63221,42.0,6709,4.5,37226,24.7,43546,28.9,69930,69930,(X),9.6,65203,65203,37997,58.3,35609,54.6,31897,48.9,19756,19756,9983,50.5,25522,25522,15985,62.6
37135,118152,118152,76548,64.8,76525,64.8,73172,61.9,3353,2.8,23,0.0,41604,35.2,76525,76525,(X),4.4,62777,62777,38962,62.1,38962,62.1,37377,59.5,7926,7926,5803,73.2,19779,19779,14448,73.0
37137,11032,11032,5227,47.4,5220,47.3,4806,43.6,414,3.8,7,0.1,5805,52.6,5220,5220,(X),7.9,5436,5436,2526,46.5,2526,46.5,2372,43.6,466,466,295,63.3,1339,1339,843,63.0
37139,31516,31516,18101,57.4,17476,55.5,16289,51.7,1187,3.8,625,2.0,13415,42.6,17476,17476,(X),6.8,16255,16255,8655,53.2,8559,52.7,7976,49.1,2980,2980,1742,58.5,5429,5429,4074,75.0
37141,47537,47537,27790,58.5,27332,57.5,25316,53.3,2016,4.2,458,1.0,19747,41.5,27332,27332,(X),7.4,24062,24062,12969,53.9,12922,53.7,11983,49.8,3919,3919,2915,74.4,8518,8518,5775,67.8
37143,11206,11206,5769,51.5,5688,50.8,5305,47.3,383,3.4,81,0.7,5437,48.5,5688,5688,(X),6.7,5799,5799,2668,46.0,2668,46.0,2518,43.4,609,609,386,63.4,1837,1837,1232,67.1
37145,32048,32048,19820,61.8,19768,61.7,18065,56.4,1703,5.3,52,0.2,12228,38.2,19768,19768,(X),8.6,16663,16663,10037,60.2,10037,60.2,9168,55.0,2418,2418,1956,80.9,5234,5234,3927,75.0
37147,143129,143129,91851,64.2,91627,64.0,83183,58.1,8444,5.9,224,0.2,51278,35.8,91627,91627,(X),9.2,77347,77347,46977,60.7,46941,60.7,42444,54.9,12041,12041,8875,73.7,24104,24104,19282,80.0
37149,17444,17444,9114,52.2,9092,52.1,8617,49.4,475,2.7,22,0.1,8330,47.8,9092,9092,(X),5.2,9254,9254,4637,50.1,4637,50.1,4396,47.5,779,779,586,75.2,2374,2374,1792,75.5
37151,114098,114098,69513,60.9,69457,60.9,65738,57.6,3719,3.3,56,0.0,44585,39.1,69457,69457,(X),5.4,58459,58459,32625,55.8,32625,55.8,30566,52.3,9249,9249,5901,63.8,21877,21877,14884,68.0
37153,35994,35994,19521,54.2,19230,53.4,17389,48.3,1841,5.1,291,0.8,16473,45.8,19230,19230,(X),9.6,18589,18589,9913,53.3,9913,53.3,8780,47.2,3129,3129,2269,72.5,6284,6284,4427,70.4
37155,103637,103637,52264,50.4,52163,50.3,47923,46.2,4240,4.1,101,0.1,51373,49.6,52163,52163,(X),8.1,54514,54514,25762,47.3,25762,47.3,23649,43.4,10227,10227,5769,56.4,20637,20637,12785,62.0
37157,74778,74778,42071,56.3,42031,56.2,39463,52.8,2568,3.4,40,0.1,32707,43.7,42031,42031,(X),6.1,39104,39104,20097,51.4,20097,51.4,18812,48.1,5659,5659,3437,60.7,11905,11905,8371,70.3
37159,112028,112028,66646,59.5,66597,59.4,61491,54.9,5106,4.6,49,0.0,45382,40.5,66597,66597,(X),7.7,57126,57126,31684,55.5,31670,55.4,29123,51.0,8860,8860,5794,65.4,20777,20777,14223,68.5
37161,54391,54391,28892,53.1,28832,53.0,26422,48.6,2410,4.4,60,0.1,25499,46.9,28832,28832,(X),8.4,28363,28363,13404,47.3,13404,47.3,12176,42.9,3804,3804,2180,57.3,8991,8991,5542,61.6
37163,49625,49625,29087,58.6,29042,58.5,26584,53.6,2458,5.0,45,0.1,20538,41.4,29042,29042,(X),8.5,25478,25478,13223,51.9,13217,51.9,11860,46.5,4561,4561,3079,67.5,9596,9596,6890,71.8
37165,27985,27985,13808,49.3,13808,49.3,12081,43.2,1727,6.2,0,0.0,14177,50.7,13808,13808,(X),12.5,14280,14280,7060,49.4,7060,49.4,6120,42.9,2495,2495,1708,68.5,4892,4892,3351,68.5
37167,49380,49380,30204,61.2,30160,61.1,28295,57.3,1865,3.8,44,0.1,19176,38.8,30160,30160,(X),6.2,24923,24923,14154,56.8,14154,56.8,13264,53.2,4039,4039,3141,77.8,8649,8649,6622,76.6
37169,38032,38032,22158,58.3,22142,58.2,20742,54.5,1400,3.7,16,0.0,15874,41.7,22142,22142,(X),6.3,19426,19426,10106,52.0,10106,52.0,9616,49.5,2339,2339,1713,73.2,6160,6160,4555,73.9
37171,58419,58419,32140,55.0,32109,55.0,30687,52.5,1422,2.4,31,0.1,26279,45.0,32109,32109,(X),4.4,30214,30214,15061,49.8,15061,49.8,14490,48.0,4351,4351,2539,58.4,10062,10062,6491,64.5
37173,11431,11431,6113,53.5,6113,53.5,5693,49.8,420,3.7,0,0.0,5318,46.5,6113,6113,(X),6.9,5947,5947,3001,50.5,3001,50.5,2867,48.2,819,819,440,53.7,1908,1908,1354,71.0
37175,28680,28680,14340,50.0,14340,50.0,13511,47.1,829,2.9,0,0.0,14340,50.0,14340,14340,(X),5.8,15112,15112,7123,47.1,7123,47.1,6754,44.7,1428,1428,1062,74.4,3542,3542,2539,71.7
37177,3623,3623,1648,45.5,1648,45.5,1560,43.1,88,2.4,0,0.0,1975,54.5,1648,1648,(X),5.3,1507,1507,859,57.0,859,57.0,812,53.9,170,170,140,82.4,350,350,276,78.9
37179,172164,172164,116292,67.5,116210,67.5,109997,63.9,6213,3.6,82,0.0,55872,32.5,116210,116210,(X),5.3,88450,88450,52901,59.8,52901,59.8,49985,56.5,15786,15786,10217,64.7,44263,44263,29730,67.2
37181,35120,35120,20511,58.4,20511,58.4,18594,52.9,1917,5.5,0,0.0,14609,41.6,20511,20511,(X),9.3,18947,18947,10568,55.8,10568,55.8,9629,50.8,2936,2936,2260,77.0,6707,6707,4990,74.4
37183,818738,818738,577568,70.5,576748,70.4,551929,67.4,24819,3.0,820,0.1,241170,29.5,576748,576748,(X),4.3,425775,425775,275149,64.6,275028,64.6,262318,61.6,78911,78911,51250,64.9,169915,169915,123130,72.5
37185,16800,16800,8023,47.8,8012,47.7,7288,43.4,724,4.3,11,0.1,8777,52.2,8012,8012,(X),9.0,8460,8460,4023,47.6,4015,47.5,3688,43.6,912,912,699,76.6,2501,2501,1831,73.2
37187,10045,10045,4847,48.3,4813,47.9,4454,44.3,359,3.6,34,0.3,5198,51.7,4813,4813,(X),7.5,5491,5491,2275,41.4,2275,41.4,2101,38.3,674,674,438,65.0,1565,1565,945,60.4
37189,48016,48016,27054,56.3,26975,56.2,24966,52.0,2009,4.2,79,0.2,20962,43.7,26975,26975,(X),7.4,24045,24045,12913,53.7,12913,53.7,11978,49.8,2227,2227,1629,73.1,4559,4559,3118,68.4
37191,97777,97777,59419,60.8,56836,58.1,52418,53.6,4418,4.5,2583,2.6,38358,39.2,56836,56836,(X),7.8,50486,50486,28041,55.5,27640,54.7,25600,50.7,9267,9267,5715,61.7,18631,18631,12721,68.3
37193,55861,55861,31084,55.6,31051,55.6,29252,52.4,1799,3.2,33,0.1,24777,44.4,31051,31051,(X),5.8,28584,28584,14404,50.4,14388,50.3,13628,47.7,3776,3776,2572,68.1,9388,9388,6415,68.3
37195,64342,64342,38236,59.4,38095,59.2,35051,54.5,3044,4.7,141,0.2,26106,40.6,38095,38095,(X),8.0,34575,34575,19361,56.0,19348,56.0,17907,51.8,5167,5167,3888,75.2,12462,12462,8810,70.7
37197,30668,30668,16644,54.3,16620,54.2,15731,51.3,889,2.9,24,0.1,14024,45.7,16620,16620,(X),5.3,15703,15703,7641,48.7,7641,48.7,7181,45.7,2259,2259,1247,55.2,5413,5413,3204,59.2
37199,14800,14800,7776,52.5,7764,52.5,7159,48.4,605,4.1,12,0.1,7024,47.5,7764,7764,(X),7.8,7614,7614,3585,47.1,3585,47.1,3270,42.9,971,971,641,66.0,2227,2227,1394,62.6
38001,1941,1941,1235,63.6,1235,63.6,1219,62.8,16,0.8,0,0.0,706,36.4,1235,1235,(X),1.3,990,990,545,55.1,545,55.1,542,54.7,102,102,102,100.0,392,392,254,64.8
38003,9010,9010,5995,66.5,5988,66.5,5830,64.7,158,1.8,7,0.1,3015,33.5,5988,5988,(X),2.6,4498,4498,2730,60.7,2728,60.6,2643,58.8,617,617,420,68.1,1381,1381,1181,85.5
38005,4713,4713,2523,53.5,2517,53.4,2372,50.3,145,3.1,6,0.1,2190,46.5,2517,2517,(X),5.8,2306,2306,1246,54.0,1246,54.0,1186,51.4,743,743,410,55.2,1282,1282,717,55.9
38007,739,739,519,70.2,519,70.2,500,67.7,19,2.6,0,0.0,220,29.8,519,519,(X),3.7,325,325,201,61.8,201,61.8,199,61.2,96,96,81,84.4,123,123,71,57.7
38009,5395,5395,3443,63.8,3419,63.4,3288,60.9,131,2.4,24,0.4,1952,36.2,3419,3419,(X),3.8,2580,2580,1453,56.3,1452,56.3,1402,54.3,445,445,226,50.8,846,846,647,76.5
38011,2494,2494,1769,70.9,1769,70.9,1725,69.2,44,1.8,0,0.0,725,29.1,1769,1769,(X),2.5,1261,1261,829,65.7,829,65.7,823,65.3,274,274,228,83.2,480,480,433,90.2
38013,1563,1563,1073,68.7,1071,68.5,1052,67.3,19,1.2,2,0.1,490,31.3,1071,1071,(X),1.8,721,721,427,59.2,427,59.2,418,58.0,234,234,138,59.0,374,374,302,80.7
38015,74299,74299,52801,71.1,52495,70.7,51500,69.3,995,1.3,306,0.4,21498,28.9,52495,52495,(X),1.9,37234,37234,25179,67.6,25127,67.5,24737,66.4,7651,7651,6103,79.8,13138,13138,11300,86.0
38017,139024,139024,104996,75.5,104601,75.2,101585,73.1,3016,2.2,395,0.3,34028,24.5,104601,104601,(X),2.9,68603,68603,49490,72.1,49467,72.1,48331,70.5,14612,14612,11579,79.2,23199,23199,19042,82.1
38019,3085,3085,1946,63.1,1946,63.1,1921,62.3,25,0.8,0,0.0,1139,36.9,1946,1946,(X),1.3,1526,1526,816,53.5,816,53.5,803,52.6,288,288,217,75.3,509,509,396,77.8
38021,3976,3976,2679,67.4,2679,67.4,2606,65.5,73,1.8,0,0.0,1297,32.6,2679,2679,(X),2.7,2046,2046,1280,62.6,1280,62.6,1228,60.0,319,319,241,75.5,806,806,650,80.6
38023,2031,2031,1183,58.2,1183,58.2,1175,57.9,8,0.4,0,0.0,848,41.8,1183,1183,(X),0.7,1049,1049,521,49.7,521,49.7,521,49.7,109,109,96,88.1,254,254,188,74.0
38025,3466,3466,2173,62.7,2173,62.7,2100,60.6,73,2.1,0,0.0,1293,37.3,2173,2173,(X),3.4,1604,1604,875,54.6,875,54.6,860,53.6,315,315,221,70.2,672,672,526,78.3
38027,1873,1873,1211,64.7,1211,64.7,1196,63.9,15,0.8,0,0.0,662,35.3,1211,1211,(X),1.2,977,977,608,62.2,608,62.2,601,61.5,229,229,201,87.8,272,272,249,91.5
38029,2763,2763,1530,55.4,1530,55.4,1508,54.6,22,0.8,0,0.0,1233,44.6,1530,1530,(X),1.4,1367,1367,719,52.6,719,52.6,710,51.9,228,228,171,75.0,410,410,301,73.4
38031,2624,2624,1815,69.2,1815,69.2,1793,68.3,22,0.8,0,0.0,809,30.8,1815,1815,(X),1.2,1313,1313,819,62.4,819,62.4,803,61.2,223,223,165,74.0,493,493,397,80.5
38033,1526,1526,1036,67.9,1036,67.9,1019,66.8,17,1.1,0,0.0,490,32.1,1036,1036,(X),1.6,791,791,471,59.5,471,59.5,459,58.0,126,126,105,83.3,252,252,208,82.5
38035,57244,57244,41260,72.1,39945,69.8,38410,67.1,1535,2.7,1315,2.3,15984,27.9,39945,39945,(X),3.8,27555,27555,18640,67.6,18368,66.7,17643,64.0,5242,5242,4045,77.2,8535,8535,6954,81.5
38037,1959,1959,1160,59.2,1160,59.2,1132,57.8,28,1.4,0,0.0,799,40.8,1160,1160,(X),2.4,970,970,518,53.4,518,53.4,508,52.4,176,176,142,80.7,291,291,228,78.4
38039,1870,1870,1197,64.0,1197,64.0,1182,63.2,15,0.8,0,0.0,673,36.0,1197,1197,(X),1.3,943,943,545,57.8,545,57.8,542,57.5,164,164,161,98.2,271,271,242,89.3
38041,2069,2069,1170,56.5,1170,56.5,1149,55.5,21,1.0,0,0.0,899,43.5,1170,1170,(X),1.8,1087,1087,507,46.6,507,46.6,496,45.6,192,192,92,47.9,328,328,233,71.0
38043,2022,2022,1286,63.6,1282,63.4,1268,62.7,14,0.7,4,0.2,736,36.4,1282,1282,(X),1.1,939,939,545,58.0,545,58.0,539,57.4,149,149,102,68.5,351,351,191,54.4
38045,3319,3319,2063,62.2,2063,62.2,2053,61.9,10,0.3,0,0.0,1256,37.8,2063,2063,(X),0.5,1614,1614,862,53.4,862,53.4,860,53.3,217,217,132,60.8,582,582,430,73.9
38047,1607,1607,1002,62.4,1002,62.4,993,61.8,9,0.6,0,0.0,605,37.6,1002,1002,(X),0.9,782,782,440,56.3,440,56.3,436,55.8,137,137,112,81.8,223,223,195,87.4
38049,4678,4678,3005,64.2,2972,63.5,2923,62.5,49,1.0,33,0.7,1673,35.8,2972,2972,(X),1.6,2275,2275,1266,55.6,1264,55.6,1251,55.0,413,413,267,64.6,923,923,683,74.0
38051,2231,2231,1398,62.7,1395,62.5,1391,62.3,4,0.2,3,0.1,833,37.3,1395,1395,(X),0.3,1142,1142,652,57.1,652,57.1,652,57.1,163,163,144,88.3,294,294,254,86.4
38053,9058,9058,6641,73.3,6641,73.3,6393,70.6,248,2.7,0,0.0,2417,26.7,6641,6641,(X),3.7,4035,4035,2550,63.2,2550,63.2,2469,61.2,1330,1330,619,46.5,2302,2302,1652,71.8
38055,7747,7747,4644,59.9,4609,59.5,4545,58.7,64,0.8,35,0.5,3103,40.1,4609,4609,(X),1.4,3751,3751,2001,53.3,1983,52.9,1967,52.4,648,648,420,64.8,1320,1320,1039,78.7
38057,6849,6849,4438,64.8,4438,64.8,4397,64.2,41,0.6,0,0.0,2411,35.2,4438,4438,(X),0.9,3322,3322,1928,58.0,1928,58.0,1909,57.5,585,585,381,65.1,1212,1212,962,79.4
38059,24424,24424,17841,73.0,17831,73.0,17282,70.8,549,2.2,10,0.0,6583,27.0,17831,17831,(X),3.1,11786,11786,8201,69.6,8198,69.6,7907,67.1,2221,2221,1826,82.2,4346,4346,3725,85.7
38061,7729,7729,4936,63.9,4930,63.8,4726,61.1,204,2.6,6,0.1,2793,36.1,4930,4930,(X),4.1,3476,3476,2042,58.7,2042,58.7,1992,57.3,941,941,512,54.4,1621,1621,1150,70.9
38063,2445,2445,1493,61.1,1491,61.0,1486,60.8,5,0.2,2,0.1,952,38.9,1491,1491,(X),0.3,1204,1204,633,52.6,633,52.6,632,52.5,176,176,131,74.4,344,344,262,76.2
38065,1434,1434,855,59.6,850,59.3,813,56.7,37,2.6,5,0.3,579,40.4,850,850,(X),4.4,712,712,383,53.8,383,53.8,360,50.6,138,138,88,63.8,297,297,201,67.7
38067,5709,5709,3597,63.0,3550,62.2,3450,60.4,100,1.8,47,0.8,2112,37.0,3550,3550,(X),2.8,2740,2740,1519,55.4,1515,55.3,1471,53.7,430,430,304,70.7,943,943,662,70.2
38069,3409,3409,2073,60.8,2070,60.7,2050,60.1,20,0.6,3,0.1,1336,39.2,2070,2070,(X),1.0,1719,1719,926,53.9,926,53.9,912,53.1,352,352,182,51.7,540,540,423,78.3
38071,9247,9247,6277,67.9,6072,65.7,6025,65.2,47,0.5,205,2.2,2970,32.1,6072,6072,(X),0.8,4581,4581,3024,66.0,3003,65.6,2981,65.1,866,866,794,91.7,1663,1663,1487,89.4
38073,4374,4374,2820,64.5,2820,64.5,2782,63.6,38,0.9,0,0.0,1554,35.5,2820,2820,(X),1.3,2200,2200,1251,56.9,1251,56.9,1249,56.8,304,304,215,70.7,824,824,581,70.5
38075,1952,1952,1252,64.1,1237,63.4,1214,62.2,23,1.2,15,0.8,700,35.9,1237,1237,(X),1.9,949,949,473,49.8,473,49.8,471,49.6,226,226,135,59.7,329,329,216,65.7
38077,13226,13226,8908,67.4,8897,67.3,8628,65.2,269,2.0,11,0.1,4318,32.6,8897,8897,(X),3.0,6256,6256,4043,64.6,4043,64.6,3908,62.5,1038,1038,848,81.7,2319,2319,1955,84.3
38079,10130,10130,5661,55.9,5661,55.9,5214,51.5,447,4.4,0,0.0,4469,44.1,5661,5661,(X),7.9,5182,5182,2933,56.6,2933,56.6,2788,53.8,1441,1441,801,55.6,2624,2624,1716,65.4
38081,3201,3201,2179,68.1,2179,68.1,2151,67.2,28,0.9,0,0.0,1022,31.9,2179,2179,(X),1.3,1506,1506,897,59.6,897,59.6,880,58.4,233,233,202,86.7,484,484,403,83.3
38083,1207,1207,613,50.8,613,50.8,597,49.5,16,1.3,0,0.0,594,49.2,613,613,(X),2.6,577,577,250,43.3,250,43.3,237,41.1,93,93,34,36.6,106,106,56,52.8
38085,2967,2967,1600,53.9,1596,53.8,1340,45.2,256,8.6,4,0.1,1367,46.1,1596,1596,(X),16.0,1490,1490,789,53.0,787,52.8,700,47.0,430,430,251,58.4,936,936,663,70.8
38087,572,572,340,59.4,340,59.4,336,58.7,4,0.7,0,0.0,232,40.6,340,340,(X),1.2,262,262,115,43.9,115,43.9,111,42.4,55,55,27,49.1,96,96,61,63.5
38089,23781,23781,16953,71.3,16940,71.2,16382,68.9,558,2.3,13,0.1,6828,28.7,16940,16940,(X),3.3,11430,11430,7124,62.3,7124,62.3,6909,60.4,2846,2846,1771,62.2,4803,4803,3357,69.9
38091,1562,1562,1013,64.9,1013,64.9,991,63.4,22,1.4,0,0.0,549,35.1,1013,1013,(X),2.2,719,719,426,59.2,426,59.2,415,57.7,109,109,87,79.8,270,270,204,75.6
38093,17256,17256,11140,64.6,11121,64.4,10758,62.3,363,2.1,19,0.1,6116,35.4,11121,11121,(X),3.3,8312,8312,5025,60.5,5025,60.5,4949,59.5,1351,1351,812,60.1,2616,2616,1992,76.1
38095,1801,1801,1057,58.7,1057,58.7,1014,56.3,43,2.4,0,0.0,744,41.3,1057,1057,(X),4.1,842,842,385,45.7,385,45.7,362,43.0,145,145,38,26.2,360,360,170,47.2
38097,6428,6428,4189,65.2,4182,65.1,4056,63.1,126,2.0,7,0.1,2239,34.8,4182,4182,(X),3.0,3189,3189,1842,57.8,1842,57.8,1794,56.3,624,624,473,75.8,1126,1126,839,74.5
38099,8598,8598,5630,65.5,5628,65.5,5488,63.8,140,1.6,2,0.0,2968,34.5,5628,5628,(X),2.5,4230,4230,2530,59.8,2530,59.8,2493,58.9,804,804,540,67.2,1539,1539,1197,77.8
38101,54245,54245,40378,74.4,36818,67.9,35738,65.9,1080,2.0,3560,6.6,13867,25.6,36818,36818,(X),2.9,25786,25786,17309,67.1,16880,65.5,16356,63.4,6015,6015,3796,63.1,9670,9670,7345,76.0
38103,3299,3299,2004,60.7,1994,60.4,1941,58.8,53,1.6,10,0.3,1295,39.3,1994,1994,(X),2.7,1683,1683,905,53.8,905,53.8,864,51.3,286,286,170,59.4,550,550,445,80.9
38105,25571,25571,18604,72.8,18579,72.7,18154,71.0,425,1.7,25,0.1,6967,27.2,18579,18579,(X),2.3,11318,11318,6992,61.8,6975,61.6,6730,59.5,3455,3455,1805,52.2,5183,5183,3751,72.4
39001,21833,21833,10882,49.8,10882,49.8,10105,46.3,777,3.6,0,0.0,10951,50.2,10882,10882,(X),7.1,11015,11015,5059,45.9,5059,45.9,4689,42.6,1798,1798,1085,60.3,4536,4536,2744,60.5
39003,82330,82330,51512,62.6,51500,62.6,48430,58.8,3070,3.7,12,0.0,30818,37.4,51500,51500,(X),6.0,41036,41036,24307,59.2,24307,59.2,22859,55.7,7469,7469,6004,80.4,15695,15695,12806,81.6
39005,42866,42866,26392,61.6,26338,61.4,25271,59.0,1067,2.5,54,0.1,16474,38.4,26338,26338,(X),4.1,22103,22103,12638,57.2,12638,57.2,12201,55.2,3242,3242,2057,63.4,7980,7980,5359,67.2
39007,78985,78985,42908,54.3,42848,54.2,39737,50.3,3111,3.9,60,0.1,36077,45.7,42848,42848,(X),7.3,39541,39541,20030,50.7,20030,50.7,19003,48.1,6222,6222,3325,53.4,14099,14099,8748,62.0
39009,57356,57356,29805,52.0,29754,51.9,27470,47.9,2284,4.0,51,0.1,27551,48.0,29754,29754,(X),7.7,28967,28967,14743,50.9,14727,50.8,13604,47.0,2910,2910,1886,64.8,6158,6158,3824,62.1
39011,35997,35997,24182,67.2,24181,67.2,23343,64.8,838,2.3,1,0.0,11815,32.8,24181,24181,(X),3.5,18199,18199,10988,60.4,10988,60.4,10659,58.6,3448,3448,2700,78.3,7167,7167,5940,82.9
39013,56995,56995,30891,54.2,30874,54.2,28992,50.9,1882,3.3,17,0.0,26104,45.8,30874,30874,(X),6.1,27851,27851,14200,51.0,14200,51.0,13338,47.9,3863,3863,2321,60.1,8441,8441,5894,69.8
39015,34822,34822,20662,59.3,20648,59.3,19494,56.0,1154,3.3,14,0.0,14160,40.7,20648,20648,(X),5.6,17733,17733,9427,53.2,9427,53.2,8888,50.1,2711,2711,1886,69.6,6648,6648,4470,67.2
39017,298718,298718,193039,64.6,192925,64.6,183136,61.3,9789,3.3,114,0.0,105679,35.4,192925,192925,(X),5.1,153680,153680,91639,59.6,91597,59.6,87334,56.8,26977,26977,18747,69.5,57691,57691,42707,74.0
39019,22612,22612,13143,58.1,13143,58.1,12532,55.4,611,2.7,0,0.0,9469,41.9,13143,13143,(X),4.6,11430,11430,5872,51.4,5872,51.4,5669,49.6,1543,1543,791,51.3,3810,3810,2301,60.4
39021,31328,31328,19552,62.4,19545,62.4,18365,58.6,1180,3.8,7,0.0,11776,37.6,19545,19545,(X),6.0,15853,15853,9032,57.0,9025,56.9,8555,54.0,2274,2274,1653,72.7,5816,5816,4459,76.7
39023,108163,108163,65528,60.6,65431,60.5,60663,56.1,4768,4.4,97,0.1,42635,39.4,65431,65431,(X),7.3,56622,56622,31578,55.8,31578,55.8,29163,51.5,8983,8983,6768,75.3,19515,19515,14855,76.1
39025,160617,160617,105635,65.8,105619,65.8,101146,63.0,4473,2.8,16,0.0,54982,34.2,105619,105619,(X),4.2,82239,82239,49549,60.3,49549,60.3,47571,57.8,14099,14099,9921,70.4,32062,32062,23327,72.8
39027,33129,33129,20802,62.8,20789,62.8,19514,58.9,1275,3.8,13,0.0,12327,37.2,20789,20789,(X),6.1,16896,16896,9702,57.4,9702,57.4,9136,54.1,2908,2908,2175,74.8,6293,6293,4797,76.2
39029,85041,85041,49038,57.7,49022,57.6,45728,53.8,3294,3.9,16,0.0,36003,42.3,49022,49022,(X),6.7,42153,42153,22872,54.3,22872,54.3,21574,51.2,6198,6198,4282,69.1,13686,13686,10190,74.5
39031,28787,28787,16656,57.9,16612,57.7,15575,54.1,1037,3.6,44,0.2,12131,42.1,16612,16612,(X),6.2,14593,14593,7622,52.2,7622,52.2,7186,49.2,2525,2525,1288,51.0,5672,5672,3552,62.6
39033,33854,33854,19906,58.8,19846,58.6,18793,55.5,1053,3.1,60,0.2,13948,41.2,19846,19846,(X),5.3,17550,17550,9493,54.1,9493,54.1,9009,51.3,2852,2852,1974,69.2,5938,5938,4367,73.5
39035,1020821,1020821,644590,63.1,644380,63.1,591135,57.9,53245,5.2,210,0.0,376231,36.9,644380,644380,(X),8.3,541889,541889,322810,59.6,322759,59.6,297918,55.0,83386,83386,61582,73.9,168531,168531,126191,74.9
39037,40806,40806,26019,63.8,25984,63.7,24771,60.7,1213,3.0,35,0.1,14787,36.2,25984,25984,(X),4.7,20767,20767,11988,57.7,11988,57.7,11557,55.7,3596,3596,2438,67.8,7994,7994,6273,78.5
39039,30505,30505,19899,65.2,19868,65.1,18951,62.1,917,3.0,31,0.1,10606,34.8,19868,19868,(X),4.6,15465,15465,9318,60.3,9290,60.1,8934,57.8,2386,2386,1777,74.5,6121,6121,4861,79.4
39041,149586,149586,104328,69.7,104199,69.7,101375,67.8,2824,1.9,129,0.1,45258,30.3,104199,104199,(X),2.7,76350,76350,48174,63.1,48147,63.1,46807,61.3,14844,14844,10073,67.9,36911,36911,28503,77.2
39043,61784,61784,38103,61.7,38085,61.6,36035,58.3,2050,3.3,18,0.0,23681,38.3,38085,38085,(X),5.4,31755,31755,18390,57.9,18390,57.9,17509,55.1,4796,4796,3726,77.7,9870,9870,8053,81.6
39045,120391,120391,75488,62.7,75355,62.6,72028,59.8,3327,2.8,133,0.1,44903,37.3,75355,75355,(X),4.4,60832,60832,35665,58.6,35637,58.6,34018,55.9,10700,10700,7649,71.5,24769,24769,18151,73.3
39047,22550,22550,13374,59.3,13340,59.2,12543,55.6,797,3.5,34,0.2,9176,40.7,13340,13340,(X),6.0,11608,11608,6145,52.9,6142,52.9,5951,51.3,1924,1924,1348,70.1,4169,4169,2927,70.2
39049,1006714,1006714,702905,69.8,702381,69.8,665824,66.1,36557,3.6,524,0.1,303809,30.2,702381,702381,(X),5.2,520745,520745,341222,65.5,341119,65.5,323596,62.1,103728,103728,75305,72.6,181726,181726,137320,75.6
39051,33520,33520,21832,65.1,21832,65.1,20788,62.0,1044,3.1,0,0.0,11688,34.9,21832,21832,(X),4.8,17198,17198,10500,61.1,10500,61.1,9967,58.0,2843,2843,1954,68.7,6819,6819,5366,78.7
39053,24113,24113,12753,52.9,12753,52.9,12096,50.2,657,2.7,0,0.0,11360,47.1,12753,12753,(X),5.2,12398,12398,5886,47.5,5886,47.5,5667,45.7,2266,2266,1187,52.4,4153,4153,2216,53.4
39055,74945,74945,49306,65.8,49306,65.8,47853,63.9,1453,1.9,0,0.0,25639,34.2,49306,49306,(X),2.9,38125,38125,22544,59.1,22544,59.1,21862,57.3,5655,5655,2919,51.6,15587,15587,10057,64.5
39057,135710,135710,84975,62.6,82401,60.7,77851,57.4,4550,3.4,2574,1.9,50735,37.4,82401,82401,(X),5.5,69612,69612,39792,57.2,39342,56.5,37464,53.8,10391,10391,6437,61.9,22233,22233,15282,68.7
39059,31565,31565,18000,57.0,17945,56.9,16691,52.9,1254,4.0,55,0.2,13565,43.0,17945,17945,(X),7.0,16086,16086,8361,52.0,8361,52.0,7839,48.7,2590,2590,1519,58.6,5473,5473,3363,61.4
39061,644365,644365,429056,66.6,428852,66.6,402685,62.5,26167,4.1,204,0.0,215309,33.4,428852,428852,(X),6.1,337947,337947,210205,62.2,210150,62.2,197859,58.5,61183,61183,44550,72.8,116085,116085,88485,76.2
39063,60730,60730,40297,66.4,40249,66.3,38531,63.4,1718,2.8,48,0.1,20433,33.6,40249,40249,(X),4.3,30963,30963,18981,61.3,18981,61.3,18193,58.8,5299,5299,3761,71.0,10851,10851,7882,72.6
39065,25133,25133,15218,60.5,15218,60.5,14325,57.0,893,3.6,0,0.0,9915,39.5,15218,15218,(X),5.9,12827,12827,7166,55.9,7166,55.9,6771,52.8,2239,2239,1397,62.4,4623,4623,3015,65.2
39067,12537,12537,6804,54.3,6804,54.3,6423,51.2,381,3.0,0,0.0,5733,45.7,6804,6804,(X),5.6,6315,6315,2948,46.7,2948,46.7,2830,44.8,930,930,470,50.5,2078,2078,1419,68.3
39069,21680,21680,13915,64.2,13866,64.0,13278,61.2,588,2.7,49,0.2,7765,35.8,13866,13866,(X),4.2,11002,11002,6443,58.6,6443,58.6,6184,56.2,2010,2010,1460,72.6,4018,4018,3263,81.2
39071,33872,33872,18896,55.8,18896,55.8,17659,52.1,1237,3.7,0,0.0,14976,44.2,18896,18896,(X),6.5,17489,17489,8729,49.9,8729,49.9,8120,46.4,2887,2887,1645,57.0,6618,6618,4407,66.6
39073,23027,23027,13367,58.0,13367,58.0,12581,54.6,786,3.4,0,0.0,9660,42.0,13367,13367,(X),5.9,11594,11594,6233,53.8,6233,53.8,5924,51.1,1891,1891,1283,67.8,4170,4170,3032,72.7
39075,31461,31461,20588,65.4,20580,65.4,20133,64.0,447,1.4,8,0.0,10873,34.6,20580,20580,(X),2.2,15928,15928,8214,51.6,8214,51.6,8001,50.2,4443,4443,1053,23.7,9470,9470,3276,34.6
39077,45779,45779,28649,62.6,28630,62.5,27219,59.5,1411,3.1,19,0.0,17130,37.4,28630,28630,(X),4.9,23336,23336,13353,57.2,13353,57.2,12782,54.8,4132,4132,2731,66.1,9354,9354,6759,72.3
39079,25595,25595,15124,59.1,15124,59.1,13539,52.9,1585,6.2,0,0.0,10471,40.9,15124,15124,(X),10.5,13171,13171,7210,54.7,7210,54.7,6427,48.8,2252,2252,1611,71.5,4467,4467,3485,78.0
39081,55340,55340,29577,53.4,29569,53.4,27203,49.2,2366,4.3,8,0.0,25763,46.6,29569,29569,(X),8.0,28759,28759,14169,49.3,14161,49.2,13245,46.1,3642,3642,2349,64.5,8281,8281,5676,68.5
39083,48812,48812,30091,61.6,30039,61.5,28453,58.3,1586,3.2,52,0.1,18721,38.4,30039,30039,(X),5.3,25258,25258,14369,56.9,14331,56.7,13633,54.0,4325,4325,2832,65.5,9058,9058,5418,59.8
39085,188813,188813,123777,65.6,123735,65.5,118286,62.6,5449,2.9,42,0.0,65036,34.4,123735,123735,(X),4.4,97562,97562,59699,61.2,59699,61.2,57601,59.0,13360,13360,9698,72.6,31937,31937,25036,78.4
39087,48779,48779,25888,53.1,25888,53.1,24286,49.8,1602,3.3,0,0.0,22891,46.9,25888,25888,(X),6.2,25330,25330,12523,49.4,12523,49.4,11846,46.8,3837,3837,2586,67.4,8385,8385,5468,65.2
39089,136703,136703,87914,64.3,87830,64.2,83490,61.1,4340,3.2,84,0.1,48789,35.7,87830,87830,(X),4.9,70637,70637,42413,60.0,42394,60.0,40461,57.3,11788,11788,8229,69.8,26291,26291,19846,75.5
39091,36068,36068,22588,62.6,22580,62.6,21477,59.5,1103,3.1,8,0.0,13480,37.4,22580,22580,(X),4.9,18392,18392,10455,56.8,10455,56.8,9925,54.0,3034,3034,2034,67.0,6871,6871,4957,72.1
39093,246626,246626,151016,61.2,150868,61.2,141361,57.3,9507,3.9,148,0.1,95610,38.8,150868,150868,(X),6.3,126431,126431,74230,58.7,74226,58.7,69766,55.2,20399,20399,13910,68.2,45212,45212,33937,75.1
39095,343499,343499,216781,63.1,216534,63.0,200292,58.3,16242,4.7,247,0.1,126718,36.9,216534,216534,(X),7.5,179301,179301,106354,59.3,106342,59.3,99033,55.2,31531,31531,23132,73.4,62019,62019,47148,76.0
39097,36014,36014,20321,56.4,20315,56.4,19346,53.7,969,2.7,6,0.0,15693,43.6,20315,20315,(X),4.8,16074,16074,9422,58.6,9422,58.6,8903,55.4,2568,2568,1565,60.9,6032,6032,4182,69.3
39099,190086,190086,114052,60.0,114014,60.0,104885,55.2,9129,4.8,38,0.0,76034,40.0,114014,114014,(X),8.0,98581,98581,55041,55.8,55034,55.8,51309,52.0,13365,13365,10137,75.8,29937,29937,22097,73.8
39101,53064,53064,28341,53.4,28305,53.3,26402,49.8,1903,3.6,36,0.1,24723,46.6,28305,28305,(X),6.7,24666,24666,13407,54.4,13407,54.4,12522,50.8,4336,4336,2919,67.3,8441,8441,5967,70.7
39103,141509,141509,96153,67.9,96103,67.9,93038,65.7,3065,2.2,50,0.0,45356,32.1,96103,96103,(X),3.2,72236,72236,44802,62.0,44794,62.0,43501,60.2,11149,11149,7710,69.2,28162,28162,21665,76.9
39105,18783,18783,9866,52.5,9866,52.5,9046,48.2,820,4.4,0,0.0,8917,47.5,9866,9866,(X),8.3,9587,9587,4588,47.9,4588,47.9,4267,44.5,1329,1329,768,57.8,3405,3405,2207,64.8
39107,31625,31625,21502,68.0,21494,68.0,20927,66.2,567,1.8,8,0.0,10123,32.0,21494,21494,(X),2.6,15717,15717,9926,63.2,9926,63.2,9635,61.3,3183,3183,2644,83.1,6690,6690,5551,83.0
39109,83552,83552,53646,64.2,53519,64.1,51077,61.1,2442,2.9,127,0.2,29906,35.8,53519,53519,(X),4.6,42653,42653,25149,59.0,25129,58.9,23842,55.9,7042,7042,4741,67.3,16131,16131,12590,78.0
39111,11558,11558,5600,48.5,5590,48.4,5226,45.2,364,3.1,10,0.1,5958,51.5,5590,5590,(X),6.5,5814,5814,2383,41.0,2383,41.0,2282,39.3,827,827,464,56.1,2046,2046,1316,64.3
39113,427626,427626,264089,61.8,262404,61.4,243624,57.0,18780,4.4,1685,0.4,163537,38.2,262404,262404,(X),7.2,224728,224728,129009,57.4,128590,57.2,119445,53.2,36896,36896,25283,68.5,74942,74942,55286,73.8
39115,11947,11947,6070,50.8,6054,50.7,5752,48.1,302,2.5,16,0.1,5877,49.2,6054,6054,(X),5.0,6028,6028,2810,46.6,2810,46.6,2748,45.6,855,855,505,59.1,1994,1994,1154,57.9
39117,27907,27907,18169,65.1,18144,65.0,17483,62.6,661,2.4,25,0.1,9738,34.9,18144,18144,(X),3.6,13968,13968,8738,62.6,8738,62.6,8362,59.9,2056,2056,1499,72.9,5553,5553,4106,73.9
39119,68868,68868,40774,59.2,40765,59.2,38058,55.3,2707,3.9,9,0.0,28094,40.8,40765,40765,(X),6.6,35863,35863,19885,55.4,19885,55.4,18646,52.0,5928,5928,4151,70.0,12572,12572,9300,74.0
39121,11988,11988,4382,36.6,4381,36.5,4171,34.8,210,1.8,1,0.0,7606,63.4,4381,4381,(X),4.8,4585,4585,2148,46.8,2148,46.8,2047,44.6,855,855,341,39.9,1662,1662,860,51.7
39123,34057,34057,20439,60.0,20413,59.9,19463,57.1,950,2.8,26,0.1,13618,40.0,20413,20413,(X),4.7,17307,17307,9504,54.9,9504,54.9,9138,52.8,1921,1921,1457,75.8,5333,5333,3996,74.9
39125,14963,14963,9057,60.5,9046,60.5,8631,57.7,415,2.8,11,0.1,5906,39.5,9046,9046,(X),4.6,7550,7550,3991,52.9,3991,52.9,3793,50.2,1229,1229,1042,84.8,3063,3063,2071,67.6
39127,28442,28442,16404,57.7,16404,57.7,15170,53.3,1234,4.3,0,0.0,12038,42.3,16404,16404,(X),7.5,14326,14326,7524,52.5,7524,52.5,7011,48.9,2424,2424,1600,66.0,5583,5583,4061,72.7
39129,46515,46515,26073,56.1,26073,56.1,24995,53.7,1078,2.3,0,0.0,20442,43.9,26073,26073,(X),4.1,21655,21655,12282,56.7,12282,56.7,11704,54.0,3437,3437,2006,58.4,7905,7905,6317,79.9
39131,22394,22394,11265,50.3,11265,50.3,10316,46.1,949,4.2,0,0.0,11129,49.7,11265,11265,(X),8.4,11452,11452,5174,45.2,5174,45.2,4749,41.5,2206,2206,1306,59.2,4012,4012,2601,64.8
39133,135765,135765,88989,65.5,88961,65.5,83366,61.4,5595,4.1,28,0.0,46776,34.5,88961,88961,(X),6.3,69841,69841,42260,60.5,42260,60.5,39858,57.1,8468,8468,5828,68.8,20774,20774,15757,75.8
39135,33008,33008,20732,62.8,20732,62.8,19706,59.7,1026,3.1,0,0.0,12276,37.2,20732,20732,(X),4.9,16764,16764,9711,57.9,9711,57.9,9253,55.2,2675,2675,1903,71.1,5688,5688,4144,72.9
39137,26291,26291,18022,68.5,18013,68.5,17499,66.6,514,2.0,9,0.0,8269,31.5,18013,18013,(X),2.9,13191,13191,8373,63.5,8373,63.5,8068,61.2,2761,2761,2159,78.2,5644,5644,4496,79.7
39139,97915,97915,54457,55.6,54362,55.5,50829,51.9,3533,3.6,95,0.1,43458,44.4,54362,54362,(X),6.5,48398,48398,25910,53.5,25910,53.5,24397,50.4,7854,7854,5140,65.4,16620,16620,11787,70.9
39141,62360,62360,32931,52.8,32888,52.7,30398,48.7,2490,4.0,43,0.1,29429,47.2,32888,32888,(X),7.6,29303,29303,15398,52.5,15398,52.5,14264,48.7,4771,4771,3021,63.3,10646,10646,7168,67.3
39143,47381,47381,29663,62.6,29631,62.5,28152,59.4,1479,3.1,32,0.1,17718,37.4,29631,29631,(X),5.0,24270,24270,14156,58.3,14147,58.3,13425,55.3,3695,3695,2863,77.5,8926,8926,6791,76.1
39145,61654,61654,30515,49.5,30496,49.5,28093,45.6,2403,3.9,19,0.0,31139,50.5,30496,30496,(X),7.9,31577,31577,14840,47.0,14840,47.0,13905,44.0,4537,4537,2678,59.0,10691,10691,7109,66.5
39147,44719,44719,27416,61.3,27416,61.3,26063,58.3,1353,3.0,0,0.0,17303,38.7,27416,27416,(X),4.9,22639,22639,12977,57.3,12977,57.3,12173,53.8,3399,3399,2668,78.5,7967,7967,6259,78.6
39149,38005,38005,25942,68.3,25942,68.3,24780,65.2,1162,3.1,0,0.0,12063,31.7,25942,25942,(X),4.5,18991,18991,11551,60.8,11551,60.8,11238,59.2,3342,3342,2595,77.6,8299,8299,6768,81.6
39151,302274,302274,190289,63.0,190187,62.9,178755,59.1,11432,3.8,102,0.0,111985,37.0,190187,190187,(X),6.0,157314,157314,90812,57.7,90783,57.7,85688,54.5,24182,24182,17454,72.2,52423,52423,39811,75.9
39153,440926,440926,282885,64.2,282703,64.1,266743,60.5,15960,3.6,182,0.0,158041,35.8,282703,282703,(X),5.6,229693,229693,136514,59.4,136496,59.4,129223,56.3,35313,35313,24504,69.4,74146,74146,54978,74.1
39155,165014,165014,92574,56.1,92469,56.0,87675,53.1,4794,2.9,105,0.1,72440,43.9,92469,92469,(X),5.2,85482,85482,44136,51.6,44132,51.6,42173,49.3,12339,12339,7640,61.9,27530,27530,18642,67.7
39157,73711,73711,45856,62.2,45839,62.2,43937,59.6,1902,2.6,17,0.0,27855,37.8,45839,45839,(X),4.1,37919,37919,20968,55.3,20968,55.3,20042,52.9,6257,6257,3823,61.1,13621,13621,9148,67.2
39159,43484,43484,28494,65.5,28482,65.5,27762,63.8,720,1.7,12,0.0,14990,34.5,28482,28482,(X),2.5,22755,22755,12907,56.7,12907,56.7,12592,55.3,3814,3814,2735,71.7,9400,9400,7682,81.7
39161,22463,22463,14255,63.5,14255,63.5,13624,60.7,631,2.8,0,0.0,8208,36.5,14255,14255,(X),4.4,11469,11469,6782,59.1,6782,59.1,6468,56.4,1992,1992,1493,74.9,4314,4314,3357,77.8
39163,10530,10530,5826,55.3,5826,55.3,5253,49.9,573,5.4,0,0.0,4704,44.7,5826,5826,(X),9.8,5289,5289,2698,51.0,2698,51.0,2477,46.8,749,749,375,50.1,1911,1911,1339,70.1
39165,176062,176062,116066,65.9,115837,65.8,111724,63.5,4113,2.3,229,0.1,59996,34.1,115837,115837,(X),3.6,88140,88140,54424,61.7,54341,61.7,52457,59.5,15356,15356,10679,69.5,39993,39993,29459,73.7
39167,50187,50187,28230,56.2,28180,56.1,27060,53.9,1120,2.2,50,0.1,21957,43.8,28180,28180,(X),4.0,25636,25636,13063,51.0,13063,51.0,12571,49.0,3416,3416,2113,61.9,7748,7748,5542,71.5
39169,91049,91049,57873,63.6,57855,63.5,55599,61.1,2256,2.5,18,0.0,33176,36.4,57855,57855,(X),3.9,46478,46478,26246,56.5,26246,56.5,25044,53.9,9200,9200,5348,58.1,18035,18035,11793,65.4
39171,29500,29500,18568,62.9,18543,62.9,17734,60.1,809,2.7,25,0.1,10932,37.1,18543,18543,(X),4.4,14871,14871,8740,58.8,8715,58.6,8334,56.0,2409,2409,1757,72.9,5551,5551,4309,77.6
39173,106649,106649,72503,68.0,72255,67.8,68820,64.5,3435,3.2,248,0.2,34146,32.0,72255,72255,(X),4.8,54764,54764,34646,63.3,34599,63.2,33084,60.4,7969,7969,5596,70.2,17336,17336,13161,75.9
39175,17683,17683,11367,64.3,11367,64.3,10939,61.9,428,2.4,0,0.0,6316,35.7,11367,11367,(X),3.8,8988,8988,5422,60.3,5422,60.3,5235,58.2,1397,1397,1129,80.8,3408,3408,2800,82.2
40001,16876,16876,8561,50.7,8545,50.6,8089,47.9,456,2.7,16,0.1,8315,49.3,8545,8545,(X),5.3,8545,8545,3988,46.7,3988,46.7,3787,44.3,1767,1767,905,51.2,3540,3540,2004,56.6
40003,4817,4817,2283,47.4,2283,47.4,2205,45.8,78,1.6,0,0.0,2534,52.6,2283,2283,(X),3.4,1876,1876,915,48.8,915,48.8,868,46.3,346,346,231,66.8,728,728,463,63.6
40005,11093,11093,5003,45.1,5000,45.1,4702,42.4,298,2.7,3,0.0,6090,54.9,5000,5000,(X),6.0,5261,5261,2510,47.7,2510,47.7,2372,45.1,960,960,632,65.8,1976,1976,1272,64.4
40007,4198,4198,2507,59.7,2507,59.7,2395,57.1,112,2.7,0,0.0,1691,40.3,2507,2507,(X),4.5,2068,2068,1020,49.3,1020,49.3,970,46.9,365,365,210,57.5,911,911,572,62.8
40009,17368,17368,9510,54.8,9510,54.8,9113,52.5,397,2.3,0,0.0,7858,45.2,9510,9510,(X),4.2,7826,7826,3837,49.0,3837,49.0,3654,46.7,2008,2008,1234,61.5,3303,3303,2280,69.0
40011,7760,7760,3729,48.1,3729,48.1,3618,46.6,111,1.4,0,0.0,4031,51.9,3729,3729,(X),3.0,3685,3685,1825,49.5,1825,49.5,1778,48.2,509,509,293,57.6,1227,1227,877,71.5
40013,36215,36215,20479,56.5,20479,56.5,19332,53.4,1147,3.2,0,0.0,15736,43.5,20479,20479,(X),5.6,18727,18727,9699,51.8,9699,51.8,9216,49.2,3275,3275,1967,60.1,6550,6550,4241,64.7
40015,22830,22830,12197,53.4,12193,53.4,11272,49.4,921,4.0,4,0.0,10633,46.6,12193,12193,(X),7.6,10817,10817,5242,48.5,5238,48.4,4889,45.2,2269,2269,1355,59.7,4355,4355,2907,66.8
40017,104609,104609,72016,68.8,71856,68.7,68679,65.7,3177,3.0,160,0.2,32593,31.2,71856,71856,(X),4.4,52962,52962,34058,64.3,34019,64.2,32585,61.5,11272,11272,8193,72.7,23417,23417,17843,76.2
40019,37421,37421,22143,59.2,22143,59.2,20921,55.9,1222,3.3,0,0.0,15278,40.8,22143,22143,(X),5.5,19452,19452,10465,53.8,10465,53.8,9865,50.7,3847,3847,2544,66.1,7329,7329,5109,69.7
40021,38882,38882,20691,53.2,20652,53.1,19115,49.2,1537,4.0,39,0.1,18191,46.8,20652,20652,(X),7.4,19884,19884,10119,50.9,10119,50.9,9386,47.2,3283,3283,1932,58.8,6943,6943,4747,68.4
40023,11674,11674,5593,47.9,5593,47.9,5094,43.6,499,4.3,0,0.0,6081,52.1,5593,5593,(X),8.9,6117,6117,2682,43.8,2682,43.8,2532,41.4,1131,1131,683,60.4,2154,2154,1300,60.4
40025,1712,1712,1018,59.5,1018,59.5,999,58.4,19,1.1,0,0.0,694,40.5,1018,1018,(X),1.9,865,865,458,52.9,458,52.9,450,52.0,186,186,123,66.1,328,328,195,59.5
40027,222726,222726,147797,66.4,146558,65.8,140468,63.1,6090,2.7,1239,0.6,74929,33.6,146558,146558,(X),4.2,112419,112419,69764,62.1,69582,61.9,66819,59.4,18359,18359,12398,67.5,38998,38998,28342,72.7
40029,4371,4371,2340,53.5,2339,53.5,2186,50.0,153,3.5,1,0.0,2031,46.5,2339,2339,(X),6.5,2212,2212,1058,47.8,1058,47.8,1010,45.7,399,399,192,48.1,817,817,545,66.7
40031,96272,96272,61646,64.0,52694,54.7,48797,50.7,3897,4.0,8952,9.3,34626,36.0,52694,52694,(X),7.4,46170,46170,27348,59.2,25733,55.7,23858,51.7,9917,9917,5605,56.5,16844,16844,11654,69.2
40033,4761,4761,2582,54.2,2574,54.1,2379,50.0,195,4.1,8,0.2,2179,45.8,2574,2574,(X),7.6,2420,2420,1182,48.8,1182,48.8,1090,45.0,305,305,208,68.2,871,871,673,77.3
40035,11667,11667,6058,51.9,6058,51.9,5708,48.9,350,3.0,0,0.0,5609,48.1,6058,6058,(X),5.8,5666,5666,2840,50.1,2840,50.1,2710,47.8,891,891,520,58.4,1999,1999,1405,70.3
40037,56087,56087,31694,56.5,31664,56.5,30518,54.4,1146,2.0,30,0.1,24393,43.5,31664,31664,(X),3.6,28612,28612,14285,49.9,14275,49.9,13849,48.4,5111,5111,2975,58.2,10820,10820,7095,65.6
40039,22602,22602,14369,63.6,14369,63.6,13892,61.5,477,2.1,0,0.0,8233,36.4,14369,14369,(X),3.3,11374,11374,6600,58.0,6600,58.0,6386,56.1,2911,2911,1488,51.1,4167,4167,2760,66.2
40041,34440,34440,16587,48.2,16581,48.1,15339,44.5,1242,3.6,6,0.0,17853,51.8,16581,16581,(X),7.5,17600,17600,7952,45.2,7952,45.2,7320,41.6,2291,2291,1386,60.5,5339,5339,3422,64.1
40043,3719,3719,2164,58.2,2161,58.1,2125,57.1,36,1.0,3,0.1,1555,41.8,2161,2161,(X),1.7,1892,1892,922,48.7,922,48.7,911,48.2,392,392,191,48.7,903,903,399,44.2
40045,3222,3222,1895,58.8,1895,58.8,1790,55.6,105,3.3,0,0.0,1327,41.2,1895,1895,(X),5.5,1667,1667,859,51.5,859,51.5,817,49.0,279,279,186,66.7,615,615,450,73.2
40047,47472,47472,30531,64.3,29525,62.2,28012,59.0,1513,3.2,1006,2.1,16941,35.7,29525,29525,(X),5.1,24075,24075,13768,57.2,13614,56.5,12986,53.9,5230,5230,3049,58.3,10263,10263,6857,66.8
40049,21666,21666,11210,51.7,11204,51.7,10798,49.8,406,1.9,6,0.0,10456,48.3,11204,11204,(X),3.6,11052,11052,4922,44.5,4922,44.5,4730,42.8,2168,2168,1157,53.4,4165,4165,2660,63.9
40051,42986,42986,25643,59.7,25605,59.6,24655,57.4,950,2.2,38,0.1,17343,40.3,25605,25605,(X),3.7,21754,21754,11515,52.9,11508,52.9,11215,51.6,3802,3802,2227,58.6,8816,8816,6193,70.2
40053,3482,3482,2115,60.7,2112,60.7,2048,58.8,64,1.8,3,0.1,1367,39.3,2112,2112,(X),3.0,1701,1701,923,54.3,923,54.3,905,53.2,285,285,193,67.7,685,685,528,77.1
40055,4932,4932,2177,44.1,2177,44.1,1993,40.4,184,3.7,0,0.0,2755,55.9,2177,2177,(X),8.5,2011,2011,1062,52.8,1062,52.8,961,47.8,371,371,198,53.4,679,679,426,62.7
40057,2137,2137,1292,60.5,1292,60.5,1237,57.9,55,2.6,0,0.0,845,39.5,1292,1292,(X),4.3,1102,1102,607,55.1,607,55.1,579,52.5,175,175,148,84.6,433,433,364,84.1
40059,2942,2942,1780,60.5,1778,60.4,1742,59.2,36,1.2,2,0.1,1162,39.5,1778,1778,(X),2.0,1486,1486,742,49.9,742,49.9,723,48.7,348,348,225,64.7,646,646,436,67.5
40061,10011,10011,5082,50.8,5080,50.7,4612,46.1,468,4.7,2,0.0,4929,49.2,5080,5080,(X),9.2,5132,5132,2330,45.4,2330,45.4,2107,41.1,853,853,445,52.2,1901,1901,1136,59.8
40063,10905,10905,4549,41.7,4549,41.7,4164,38.2,385,3.5,0,0.0,6356,58.3,4549,4549,(X),8.5,5025,5025,2045,40.7,2045,40.7,1889,37.6,838,838,429,51.2,1827,1827,1101,60.3
40065,19377,19377,12209,63.0,11129,57.4,10559,54.5,570,2.9,1080,5.6,7168,37.0,11129,11129,(X),5.1,9808,9808,5354,54.6,5255,53.6,4887,49.8,2317,2317,1298,56.0,3714,3714,2534,68.2
40067,4915,4915,2448,49.8,2448,49.8,2272,46.2,176,3.6,0,0.0,2467,50.2,2448,2448,(X),7.2,2468,2468,1046,42.4,1046,42.4,972,39.4,464,464,251,54.1,912,912,578,63.4
40069,8739,8739,4414,50.5,4410,50.5,4097,46.9,313,3.6,4,0.0,4325,49.5,4410,4410,(X),7.1,4470,4470,2105,47.1,2105,47.1,1943,43.5,743,743,508,68.4,1611,1611,1031,64.0
40071,34981,34981,20342,58.2,20330,58.1,18912,54.1,1418,4.1,12,0.0,14639,41.8,20330,20330,(X),7.0,17861,17861,9231,51.7,9231,51.7,8653,48.4,3425,3425,2113,61.7,6901,6901,4677,67.8
40073,11880,11880,7591,63.9,7591,63.9,7205,60.6,386,3.2,0,0.0,4289,36.1,7591,7591,(X),5.1,5989,5989,3208,53.6,3208,53.6,3121,52.1,1220,1220,633,51.9,2879,2879,1902,66.1
40075,7125,7125,4177,58.6,4165,58.5,3969,55.7,196,2.8,12,0.2,2948,41.4,4165,4165,(X),4.7,3646,3646,1837,50.4,1837,50.4,1780,48.8,688,688,433,62.9,1090,1090,578,53.0
40077,8495,8495,4222,49.7,4222,49.7,3880,45.7,342,4.0,0,0.0,4273,50.3,4222,4222,(X),8.1,4210,4210,1959,46.5,1959,46.5,1785,42.4,646,646,466,72.1,1329,1329,897,67.5
40079,39282,39282,20328,51.7,20309,51.7,19091,48.6,1218,3.1,19,0.0,18954,48.3,20309,20309,(X),6.0,19702,19702,9412,47.8,9412,47.8,8872,45.0,3519,3519,1996,56.7,7314,7314,4786,65.4
40081,27379,27379,15146,55.3,15140,55.3,14330,52.3,810,3.0,6,0.0,12233,44.7,15140,15140,(X),5.4,13899,13899,6775,48.7,6775,48.7,6434,46.3,2297,2297,1251,54.5,5422,5422,3444,63.5
40083,36416,36416,22752,62.5,22700,62.3,21580,59.3,1120,3.1,52,0.1,13664,37.5,22700,22700,(X),4.9,18621,18621,10312,55.4,10301,55.3,9668,51.9,3205,3205,1908,59.5,6972,6972,5008,71.8
40085,7747,7747,4289,55.4,4289,55.4,4103,53.0,186,2.4,0,0.0,3458,44.6,4289,4289,(X),4.3,3889,3889,1978,50.9,1978,50.9,1904,49.0,710,710,510,71.8,1637,1637,1141,69.7
40087,29785,29785,18617,62.5,18543,62.3,17918,60.2,625,2.1,74,0.2,11168,37.5,18543,18543,(X),3.4,15201,15201,8237,54.2,8230,54.1,7849,51.6,2795,2795,1651,59.1,6762,6762,4604,68.1
40089,25497,25497,13253,52.0,13253,52.0,12437,48.8,816,3.2,0,0.0,12244,48.0,13253,13253,(X),6.2,13123,13123,6145,46.8,6145,46.8,5819,44.3,2620,2620,1548,59.1,5001,5001,3235,64.7
40091,16236,16236,7417,45.7,7417,45.7,6895,42.5,522,3.2,0,0.0,8819,54.3,7417,7417,(X),7.0,8279,8279,3507,42.4,3507,42.4,3251,39.3,1214,1214,740,61.0,2463,2463,1502,61.0
40093,5942,5942,3494,58.8,3492,58.8,3390,57.1,102,1.7,2,0.0,2448,41.2,3492,3492,(X),2.9,3022,3022,1452,48.0,1452,48.0,1396,46.2,594,594,250,42.1,1257,1257,539,42.9
40095,12972,12972,6813,52.5,6813,52.5,6534,50.4,279,2.2,0,0.0,6159,47.5,6813,6813,(X),4.1,6559,6559,3127,47.7,3127,47.7,3044,46.4,1072,1072,674,62.9,2362,2362,1566,66.3
40097,32511,32511,18221,56.0,18195,56.0,17234,53.0,961,3.0,26,0.1,14290,44.0,18195,18195,(X),5.3,16398,16398,8242,50.3,8242,50.3,7798,47.6,2867,2867,1611,56.2,5723,5723,3843,67.2
40099,11002,11002,6231,56.6,6231,56.6,5992,54.5,239,2.2,0,0.0,4771,43.4,6231,6231,(X),3.8,5540,5540,2782,50.2,2782,50.2,2658,48.0,916,916,705,77.0,2193,2193,1436,65.5
40101,53903,53903,28721,53.3,28700,53.2,26897,49.9,1803,3.3,21,0.0,25182,46.7,28700,28700,(X),6.3,28006,28006,13383,47.8,13383,47.8,12641,45.1,5166,5166,3190,61.7,10239,10239,6752,65.9
40103,8955,8955,5356,59.8,5352,59.8,5133,57.3,219,2.4,4,0.0,3599,40.2,5352,5352,(X),4.1,4524,4524,2396,53.0,2396,53.0,2291,50.6,770,770,532,69.1,1793,1793,1275,71.1
40105,8289,8289,4693,56.6,4693,56.6,4347,52.4,346,4.2,0,0.0,3596,43.4,4693,4693,(X),7.4,4212,4212,2204,52.3,2204,52.3,2028,48.1,685,685,387,56.5,1475,1475,939,63.7
40107,9587,9587,4244,44.3,4241,44.2,3866,40.3,375,3.9,3,0.0,5343,55.7,4241,4241,(X),8.8,4342,4342,1990,45.8,1990,45.8,1852,42.7,790,790,422,53.4,1755,1755,1016,57.9
40109,601082,601082,394091,65.6,389900,64.9,370683,61.7,19217,3.2,4191,0.7,206991,34.4,389900,389900,(X),4.9,310828,310828,184788,59.5,183986,59.2,175069,56.3,68207,68207,42860,62.8,122123,122123,83731,68.6
40111,30715,30715,16713,54.4,16691,54.3,15107,49.2,1584,5.2,22,0.1,14002,45.6,16691,16691,(X),9.5,15794,15794,8030,50.8,8030,50.8,7350,46.5,2721,2721,1818,66.8,5565,5565,3894,70.0
40113,37892,37892,20356,53.7,20288,53.5,18960,50.0,1328,3.5,68,0.2,17536,46.3,20288,20288,(X),6.5,18988,18988,9186,48.4,9166,48.3,8656,45.6,2903,2903,1574,54.2,6724,6724,4276,63.6
40115,24673,24673,13699,55.5,13699,55.5,12799,51.9,900,3.6,0,0.0,10974,44.5,13699,13699,(X),6.6,12770,12770,6673,52.3,6673,52.3,6259,49.0,2415,2415,1741,72.1,4875,4875,3375,69.2
40117,12939,12939,6893,53.3,6886,53.2,6587,50.9,299,2.3,7,0.1,6046,46.7,6886,6886,(X),4.3,6560,6560,3020,46.0,3020,46.0,2888,44.0,1116,1116,710,63.6,2505,2505,1562,62.4
40119,67404,67404,38776,57.5,38630,57.3,36741,54.5,1889,2.8,146,0.2,28628,42.5,38630,38630,(X),4.9,32899,32899,17609,53.5,17561,53.4,16643,50.6,5276,5276,3013,57.1,9882,9882,6388,64.6
40121,35668,35668,19001,53.3,18933,53.1,17700,49.6,1233,3.5,68,0.2,16667,46.7,18933,18933,(X),6.5,17504,17504,8531,48.7,8510,48.6,7946,45.4,2946,2946,1739,59.0,5868,5868,3814,65.0
40123,30124,30124,18179,60.3,18177,60.3,17251,57.3,926,3.1,2,0.0,11945,39.7,18177,18177,(X),5.1,15626,15626,8566,54.8,8566,54.8,8087,51.8,2913,2913,2061,70.8,5411,5411,4068,75.2
40125,56665,56665,31927,56.3,31863,56.2,29887,52.7,1976,3.5,64,0.1,24738,43.7,31863,31863,(X),6.2,30079,30079,15421,51.3,15405,51.2,14545,48.4,4996,4996,3193,63.9,10957,10957,7535,68.8
40127,8906,8906,4538,51.0,4534,50.9,4196,47.1,338,3.8,4,0.0,4368,49.0,4534,4534,(X),7.5,4585,4585,2165,47.2,2165,47.2,2007,43.8,733,733,469,64.0,1458,1458,1001,68.7
40129,2810,2810,1662,59.1,1662,59.1,1558,55.4,104,3.7,0,0.0,1148,40.9,1662,1662,(X),6.3,1460,1460,739,50.6,739,50.6,712,48.8,281,281,193,68.7,613,613,482,78.6
40131,71661,71661,45709,63.8,45671,63.7,43485,60.7,2186,3.1,38,0.1,25952,36.2,45671,45671,(X),4.8,36291,36291,20670,57.0,20667,56.9,19673,54.2,6103,6103,3691,60.5,14643,14643,10190,69.6
40133,19498,19498,10204,52.3,10202,52.3,9418,48.3,784,4.0,2,0.0,9294,47.7,10202,10202,(X),7.7,10122,10122,4681,46.2,4679,46.2,4393,43.4,1762,1762,1124,63.8,3845,3845,2460,64.0
40135,32881,32881,16895,51.4,16845,51.2,15472,47.1,1373,4.2,50,0.2,15986,48.6,16845,16845,(X),8.2,16871,16871,8192,48.6,8192,48.6,7569,44.9,2773,2773,1817,65.5,5756,5756,3600,62.5
40137,34920,34920,19583,56.1,19546,56.0,18265,52.3,1281,3.7,37,0.1,15337,43.9,19546,19546,(X),6.6,18119,18119,9057,50.0,9054,50.0,8550,47.2,3016,3016,1699,56.3,6475,6475,4371,67.5
40139,15965,15965,11406,71.4,11406,71.4,11079,69.4,327,2.0,0,0.0,4559,28.6,11406,11406,(X),2.9,7293,7293,4452,61.0,4452,61.0,4335,59.4,1983,1983,1303,65.7,3651,3651,2452,67.2
40141,5904,5904,3278,55.5,3278,55.5,3124,52.9,154,2.6,0,0.0,2626,44.5,3278,3278,(X),4.7,2889,2889,1429,49.5,1429,49.5,1355,46.9,581,581,326,56.1,1005,1005,657,65.4
40143,496333,496333,330997,66.7,330702,66.6,312623,63.0,18079,3.6,295,0.1,165336,33.3,330702,330702,(X),5.5,257699,257699,155624,60.4,155587,60.4,146760,57.0,53348,53348,34161,64.0,102076,102076,72310,70.8
40145,60885,60885,38658,63.5,38607,63.4,36367,59.7,2240,3.7,51,0.1,22227,36.5,38607,38607,(X),5.8,30979,30979,17900,57.8,17890,57.7,16862,54.4,5581,5581,3581,64.2,12608,12608,8910,70.7
40147,40913,40913,23891,58.4,23884,58.4,22712,55.5,1172,2.9,7,0.0,17022,41.6,23884,23884,(X),4.9,21357,21357,11106,52.0,11099,52.0,10682,50.0,3712,3712,2038,54.9,7913,7913,5636,71.2
40149,8851,8851,5233,59.1,5227,59.1,4995,56.4,232,2.6,6,0.1,3618,40.9,5227,5227,(X),4.4,4482,4482,2259,50.4,2259,50.4,2156,48.1,898,898,468,52.1,1763,1763,1087,61.7
40151,7560,7560,4639,61.4,4639,61.4,4432,58.6,207,2.7,0,0.0,2921,38.6,4639,4639,(X),4.5,3449,3449,1962,56.9,1962,56.9,1899,55.1,574,574,444,77.4,1054,1054,776,73.6
40153,16277,16277,9759,60.0,9759,60.0,9249,56.8,510,3.1,0,0.0,6518,40.0,9759,9759,(X),5.2,7582,7582,3901,51.5,3901,51.5,3754,49.5,1749,1749,1126,64.4,3284,3284,2156,65.7
41001,13259,13259,6549,49.4,6538,49.3,5998,45.2,540,4.1,11,0.1,6710,50.6,6538,6538,(X),8.3,6515,6515,3040,46.7,3040,46.7,2790,42.8,958,958,562,58.7,1895,1895,1272,67.1
41003,76953,76953,45989,59.8,45927,59.7,43093,56.0,2834,3.7,62,0.1,30964,40.2,45927,45927,(X),6.2,38091,38091,21709,57.0,21696,57.0,20410,53.6,4271,4271,2296,53.8,9789,9789,6489,66.3
41005,327963,327963,212880,64.9,212734,64.9,202784,61.8,9950,3.0,146,0.0,115083,35.1,212734,212734,(X),4.7,167938,167938,99230,59.1,99210,59.1,94851,56.5,25535,25535,16605,65.0,59331,59331,42456,71.6
41007,31904,31904,19040,59.7,18420,57.7,17307,54.2,1113,3.5,620,1.9,12864,40.3,18420,18420,(X),6.0,16160,16160,9006,55.7,8945,55.4,8539,52.8,2315,2315,1694,73.2,4777,4777,3636,76.1
41009,41221,41221,23427,56.8,23423,56.8,21783,52.8,1640,4.0,4,0.0,17794,43.2,23423,23423,(X),7.0,20656,20656,10691,51.8,10691,51.8,10045,48.6,3124,3124,1804,57.7,7404,7404,4853,65.5
41011,52959,52959,27188,51.3,26971,50.9,24890,47.0,2081,3.9,217,0.4,25771,48.7,26971,26971,(X),7.7,27043,27043,13191,48.8,13172,48.7,12174,45.0,3432,3432,2051,59.8,7088,7088,4573,64.5
41013,18483,18483,9618,52.0,9618,52.0,8797,47.6,821,4.4,0,0.0,8865,48.0,9618,9618,(X),8.5,9476,9476,4608,48.6,4608,48.6,4234,44.7,1261,1261,964,76.4,2922,2922,2351,80.5
41015,19628,19628,8198,41.8,8155,41.5,7503,38.2,652,3.3,43,0.2,11430,58.2,8155,8155,(X),8.0,10003,10003,3796,37.9,3796,37.9,3631,36.3,976,976,741,75.9,2047,2047,1297,63.4
41017,147287,147287,92878,63.1,92849,63.0,88057,59.8,4792,3.3,29,0.0,54409,36.9,92849,92849,(X),5.2,75186,75186,43923,58.4,43923,58.4,41431,55.1,11239,11239,6873,61.2,25052,25052,18591,74.2
41019,90130,90130,45605,50.6,45542,50.5,41847,46.4,3695,4.1,63,0.1,44525,49.4,45542,45542,(X),8.1,46079,46079,21303,46.2,21287,46.2,19587,42.5,6111,6111,4100,67.1,12940,12940,9114,70.4
41021,1554,1554,809,52.1,809,52.1,734,47.2,75,4.8,0,0.0,745,47.9,809,809,(X),9.3,818,818,374,45.7,374,45.7,335,41.0,114,114,61,53.5,275,275,213,77.5
41023,6054,6054,3260,53.8,3245,53.6,3002,49.6,243,4.0,15,0.2,2794,46.2,3245,3245,(X),7.5,3016,3016,1544,51.2,1544,51.2,1484,49.2,376,376,192,51.1,836,836,670,80.1
41025,5935,5935,3333,56.2,3333,56.2,2898,48.8,435,7.3,0,0.0,2602,43.8,3333,3333,(X),13.1,2970,2970,1583,53.3,1583,53.3,1352,45.5,436,436,321,73.6,978,978,633,64.7
41027,18096,18096,12060,66.6,12060,66.6,11557,63.9,503,2.8,0,0.0,6036,33.4,12060,12060,(X),4.2,9024,9024,5277,58.5,5277,58.5,5069,56.2,1705,1705,1114,65.3,3439,3439,2603,75.7
41029,174754,174754,100359,57.4,100280,57.4,93750,53.6,6530,3.7,79,0.0,74395,42.6,100280,100280,(X),6.5,90651,90651,48877,53.9,48866,53.9,45787,50.5,13627,13627,8290,60.8,29166,29166,20371,69.8
41031,18363,18363,9508,51.8,9508,51.8,8558,46.6,950,5.2,0,0.0,8855,48.2,9508,9508,(X),10.0,8820,8820,4556,51.7,4556,51.7,4153,47.1,1596,1596,1040,65.2,3343,3343,2743,82.1
41033,70981,70981,34148,48.1,34097,48.0,31292,44.1,2805,4.0,51,0.1,36833,51.9,34097,34097,(X),8.2,36687,36687,16502,45.0,16502,45.0,15290,41.7,4483,4483,2207,49.2,10623,10623,6545,61.6
41035,53385,53385,28340,53.1,28022,52.5,25596,47.9,2426,4.5,318,0.6,25045,46.9,28022,28022,(X),8.7,26852,26852,12897,48.0,12870,47.9,11816,44.0,4292,4292,2789,65.0,8983,8983,5388,60.0
41037,6485,6485,3275,50.5,3275,50.5,3077,47.4,198,3.1,0,0.0,3210,49.5,3275,3275,(X),6.0,2977,2977,1425,47.9,1425,47.9,1302,43.7,478,478,338,70.7,921,921,671,72.9
41039,308207,308207,183228,59.4,183022,59.4,170022,55.2,13000,4.2,206,0.1,124979,40.6,183022,183022,(X),7.1,157544,157544,88077,55.9,88022,55.9,82637,52.5,20806,20806,13197,63.4,43452,43452,30469,70.1
41041,40696,40696,20531,50.4,20475,50.3,19254,47.3,1221,3.0,56,0.1,20165,49.6,20475,20475,(X),6.0,21300,21300,10001,47.0,10001,47.0,9570,44.9,2625,2625,1472,56.1,4840,4840,3217,66.5
41043,97993,97993,56840,58.0,56793,58.0,52322,53.4,4471,4.6,47,0.0,41153,42.0,56793,56793,(X),7.9,50240,50240,26686,53.1,26677,53.1,24606,49.0,8568,8568,5807,67.8,18124,18124,12517,69.1
41045,23619,23619,11750,49.7,11717,49.6,10814,45.8,903,3.8,33,0.1,11869,50.3,11717,11717,(X),7.7,10422,10422,5326,51.1,5326,51.1,4968,47.7,2420,2420,1508,62.3,5077,5077,3453,68.0
41047,260883,260883,160407,61.5,160227,61.4,150509,57.7,9718,3.7,180,0.1,100476,38.5,160227,160227,(X),6.1,131978,131978,75374,57.1,75335,57.1,71256,54.0,25500,25500,16295,63.9,53926,53926,38691,71.7
41049,8489,8489,5019,59.1,5019,59.1,4791,56.4,228,2.7,0,0.0,3470,40.9,5019,5019,(X),4.5,4194,4194,2143,51.1,2143,51.1,2011,47.9,974,974,537,55.1,2040,2040,1509,74.0
41051,659207,659207,456323,69.2,456019,69.2,430606,65.3,25413,3.9,304,0.0,202884,30.8,456019,456019,(X),5.6,334623,334623,219130,65.5,219072,65.5,206634,61.8,52058,52058,34757,66.8,95054,95054,69844,73.5
41053,64776,64776,38902,60.1,38810,59.9,35904,55.4,2906,4.5,92,0.1,25874,39.9,38810,38810,(X),7.5,33723,33723,18703,55.5,18703,55.5,17547,52.0,5365,5365,3414,63.6,12358,12358,8186,66.2
41055,1398,1398,749,53.6,748,53.5,719,51.4,29,2.1,1,0.1,649,46.4,748,748,(X),3.9,628,628,257,40.9,257,40.9,241,38.4,76,76,53,69.7,151,151,115,76.2
41057,21676,21676,10912,50.3,10880,50.2,10361,47.8,519,2.4,32,0.1,10764,49.7,10880,10880,(X),4.8,10774,10774,5103,47.4,5102,47.4,4857,45.1,1567,1567,952,60.8,3077,3077,2194,71.3
41059,59494,59494,34920,58.7,34886,58.6,32139,54.0,2747,4.6,34,0.1,24574,41.3,34886,34886,(X),7.9,28315,28315,16177,57.1,16166,57.1,14851,52.4,6054,6054,4001,66.1,12629,12629,9106,72.1
41061,20909,20909,12105,57.9,12102,57.9,11322,54.1,780,3.7,3,0.0,8804,42.1,12102,12102,(X),6.4,10643,10643,5644,53.0,5644,53.0,5320,50.0,1763,1763,1086,61.6,3604,3604,2430,67.4
41063,5787,5787,3167,54.7,3167,54.7,3025,52.3,142,2.5,0,0.0,2620,45.3,3167,3167,(X),4.5,2986,2986,1526,51.1,1526,51.1,1466,49.1,393,393,259,65.9,871,871,592,68.0
41065,20685,20685,12071,58.4,12071,58.4,11539,55.8,532,2.6,0,0.0,8614,41.6,12071,12071,(X),4.4,10385,10385,5595,53.9,5595,53.9,5371,51.7,1997,1997,1142,57.2,3587,3587,2274,63.4
41067,459926,459926,317314,69.0,317073,68.9,301195,65.5,15878,3.5,241,0.1,142612,31.0,317073,317073,(X),5.0,235032,235032,144847,61.6,144790,61.6,137287,58.4,43026,43026,26927,62.6,90555,90555,63580,70.2
41069,1223,1223,531,43.4,531,43.4,490,40.1,41,3.4,0,0.0,692,56.6,531,531,(X),7.7,619,619,240,38.8,240,38.8,223,36.0,72,72,38,52.8,134,134,64,47.8
41071,83012,83012,49802,60.0,49782,60.0,47108,56.7,2674,3.2,20,0.0,33210,40.0,49782,49782,(X),5.4,41881,41881,23161,55.3,23161,55.3,21926,52.4,7115,7115,4013,56.4,15539,15539,10615,68.3
42001,83662,83662,52679,63.0,52623,62.9,50247,60.1,2376,2.8,56,0.1,30983,37.0,52623,52623,(X),4.5,42821,42821,24802,57.9,24779,57.9,23459,54.8,5915,5915,4134,69.9,13977,13977,10805,77.3
42003,1020933,1020933,660798,64.7,660197,64.7,625294,61.2,34903,3.4,601,0.1,360135,35.3,660197,660197,(X),5.3,533918,533918,320501,60.0,320353,60.0,304690,57.1,74118,74118,52234,70.5,148010,148010,112137,75.8
42005,55092,55092,31633,57.4,31622,57.4,29632,53.8,1990,3.6,11,0.0,23459,42.6,31622,31622,(X),6.3,27844,27844,14589,52.4,14585,52.4,13841,49.7,3709,3709,2485,67.0,8645,8645,5962,69.0
42007,138010,138010,85536,62.0,85439,61.9,81095,58.8,4344,3.1,97,0.1,52474,38.0,85439,85439,(X),5.1,71766,71766,41337,57.6,41337,57.6,39481,55.0,10241,10241,7205,70.4,20967,20967,15473,73.8
42009,40151,40151,23146,57.6,23143,57.6,22017,54.8,1126,2.8,3,0.0,17005,42.4,23143,23143,(X),4.9,20285,20285,10266,50.6,10266,50.6,9786,48.2,2879,2879,1772,61.5,6419,6419,4435,69.1
42011,333733,333733,217739,65.2,217610,65.2,203128,60.9,14482,4.3,129,0.0,115994,34.8,217610,217610,(X),6.7,171465,171465,103685,60.5,103664,60.5,96850,56.5,28107,28107,20238,72.0,61954,61954,47079,76.0
42013,101507,101507,59618,58.7,59583,58.7,56627,55.8,2956,2.9,35,0.0,41889,41.3,59583,59583,(X),5.0,52532,52532,28283,53.8,28283,53.8,27136,51.7,7517,7517,5171,68.8,16448,16448,12342,75.0
42015,49353,49353,28066,56.9,28057,56.8,26708,54.1,1349,2.7,9,0.0,21287,43.1,28057,28057,(X),4.8,25119,25119,13084,52.1,13084,52.1,12444,49.5,4153,4153,2815,67.8,8844,8844,6063,68.6
42017,512939,512939,346487,67.5,346229,67.5,330564,64.4,15665,3.1,258,0.1,166452,32.5,346229,346229,(X),4.5,263442,263442,164404,62.4,164386,62.4,157288,59.7,36318,36318,26255,72.3,89872,89872,66913,74.5
42019,153124,153124,97568,63.7,97512,63.7,93394,61.0,4118,2.7,56,0.0,55556,36.3,97512,97512,(X),4.2,77893,77893,44575,57.2,44550,57.2,42571,54.7,11275,11275,7270,64.5,25647,25647,18190,70.9
42021,111584,111584,61438,55.1,61359,55.0,57311,51.4,4048,3.6,79,0.1,50146,44.9,61359,61359,(X),6.6,57167,57167,29064,50.8,29055,50.8,27245,47.7,7942,7942,5373,67.7,16642,16642,12167,73.1
42023,4051,4051,2232,55.1,2232,55.1,2152,53.1,80,2.0,0,0.0,1819,44.9,2232,2232,(X),3.6,2031,2031,990,48.7,990,48.7,958,47.2,226,226,177,78.3,475,475,360,75.8
42025,52958,52958,31616,59.7,31577,59.6,29356,55.4,2221,4.2,39,0.1,21342,40.3,31577,31577,(X),7.0,26719,26719,14624,54.7,14624,54.7,13708,51.3,3176,3176,2021,63.6,8213,8213,5872,71.5
42027,139946,139946,80197,57.3,80150,57.3,76741,54.8,3409,2.4,47,0.0,59749,42.7,80150,80150,(X),4.3,66068,66068,37354,56.5,37336,56.5,36083,54.6,7658,7658,4584,59.9,16090,16090,11527,71.6
42029,411742,411742,282660,68.6,282460,68.6,270154,65.6,12306,3.0,200,0.0,129082,31.4,282460,282460,(X),4.4,210634,210634,131488,62.4,131477,62.4,125298,59.5,34366,34366,22191,64.6,81706,81706,59147,72.4
42031,32421,32421,18883,58.2,18876,58.2,17636,54.4,1240,3.8,7,0.0,13538,41.8,18876,18876,(X),6.6,16755,16755,8897,53.1,8897,53.1,8295,49.5,2309,2309,1418,61.4,4679,4679,3211,68.6
42033,67225,67225,36495,54.3,36482,54.3,33904,50.4,2578,3.8,13,0.0,30730,45.7,36482,36482,(X),7.1,32011,32011,16449,51.4,16449,51.4,15409,48.1,4074,4074,2638,64.8,9977,9977,6579,65.9
42035,31956,31956,18945,59.3,18936,59.3,17867,55.9,1069,3.3,9,0.0,13011,40.7,18936,18936,(X),5.6,16316,16316,9054,55.5,9049,55.5,8489,52.0,2500,2500,1621,64.8,5117,5117,3534,69.1
42037,55838,55838,31692,56.8,31677,56.7,30132,54.0,1545,2.8,15,0.0,24146,43.2,31677,31677,(X),4.9,29206,29206,15054,51.5,15054,51.5,14431,49.4,3369,3369,2311,68.6,7586,7586,5395,71.1
42039,70107,70107,40890,58.3,40873,58.3,38481,54.9,2392,3.4,17,0.0,29217,41.7,40873,40873,(X),5.9,36233,36233,18851,52.0,18847,52.0,17777,49.1,5270,5270,2976,56.5,11889,11889,7828,65.8
42041,202875,202875,131487,64.8,130954,64.5,125972,62.1,4982,2.5,533,0.3,71388,35.2,130954,130954,(X),3.8,103425,103425,62711,60.6,62666,60.6,60247,58.3,15461,15461,10241,66.2,32812,32812,24303,74.1
42043,219946,219946,144517,65.7,144292,65.6,137092,62.3,7200,3.3,225,0.1,75429,34.3,144292,144292,(X),5.0,114770,114770,71538,62.3,71484,62.3,67897,59.2,19814,19814,14495,73.2,38659,38659,29510,76.3
42045,453754,453754,294637,64.9,294516,64.9,276888,61.0,17628,3.9,121,0.0,159117,35.1,294516,294516,(X),6.0,238702,238702,146290,61.3,146273,61.3,138388,58.0,39190,39190,30028,76.6,80449,80449,62302,77.4
42047,25255,25255,15829,62.7,15829,62.7,15225,60.3,604,2.4,0,0.0,9426,37.3,15829,15829,(X),3.8,12592,12592,7581,60.2,7581,60.2,7312,58.1,1733,1733,1410,81.4,3895,3895,3177,81.6
42049,222862,222862,134997,60.6,134836,60.5,126884,56.9,7952,3.6,161,0.1,87865,39.4,134836,134836,(X),5.9,113806,113806,65673,57.7,65673,57.7,62104,54.6,18159,18159,12246,67.4,39050,39050,29189,74.7
42051,110114,110114,59424,54.0,59386,53.9,55046,50.0,4340,3.9,38,0.0,50690,46.0,59386,59386,(X),7.3,55994,55994,27861,49.8,27861,49.8,26047,46.5,7743,7743,5048,65.2,16206,16206,10865,67.0
42053,6780,6780,924,13.6,924,13.6,866,12.8,58,0.9,0,0.0,5856,86.4,924,924,(X),6.3,1291,1291,371,28.7,371,28.7,352,27.3,172,172,127,73.8,363,363,227,62.5
42055,123224,123224,77447,62.9,77349,62.8,73248,59.4,4101,3.3,98,0.1,45777,37.1,77349,77349,(X),5.3,63404,63404,35870,56.6,35857,56.6,34195,53.9,10674,10674,7219,67.6,22691,22691,16924,74.6
42057,11905,11905,7013,58.9,7013,58.9,6617,55.6,396,3.3,0,0.0,4892,41.1,7013,7013,(X),5.6,5937,5937,3102,52.2,3102,52.2,2955,49.8,843,843,513,60.9,1893,1893,1347,71.2
42059,30834,30834,15349,49.8,15330,49.7,14652,47.5,678,2.2,19,0.1,15485,50.2,15330,15330,(X),4.4,14736,14736,7168,48.6,7166,48.6,6825,46.3,2172,2172,1229,56.6,4621,4621,3086,66.8
42061,38093,38093,19737,51.8,19729,51.8,18486,48.5,1243,3.3,8,0.0,18356,48.2,19729,19729,(X),6.3,17756,17756,9534,53.7,9530,53.7,8857,49.9,2327,2327,1651,70.9,5619,5619,4189,74.6
42063,71903,71903,40443,56.2,40423,56.2,37489,52.1,2934,4.1,20,0.0,31460,43.8,40423,40423,(X),7.3,36220,36220,18747,51.8,18747,51.8,17436,48.1,4510,4510,2353,52.2,10030,10030,6375,63.6
42065,35780,35780,20795,58.1,20782,58.1,19889,55.6,893,2.5,13,0.0,14985,41.9,20782,20782,(X),4.3,18134,18134,9528,52.5,9528,52.5,9195,50.7,2813,2813,1720,61.1,5987,5987,4042,67.5
42067,19639,19639,11627,59.2,11623,59.2,11171,56.9,452,2.3,4,0.0,8012,40.8,11623,11623,(X),3.9,9865,9865,4983,50.5,4983,50.5,4779,48.4,1873,1873,951,50.8,3476,3476,2234,64.3
42069,173557,173557,103371,59.6,103289,59.5,98366,56.7,4923,2.8,82,0.0,70186,40.4,103289,103289,(X),4.8,90562,90562,49601,54.8,49562,54.7,47366,52.3,12792,12792,8785,68.7,28287,28287,20293,71.7
42071,424544,424544,281457,66.3,281273,66.3,270060,63.6,11213,2.6,184,0.0,143087,33.7,281273,281273,(X),4.0,219583,219583,129906,59.2,129891,59.2,124579,56.7,41415,41415,22578,54.5,82644,82644,53629,64.9
42073,72263,72263,42123,58.3,42095,58.3,39489,54.6,2606,3.6,28,0.0,30140,41.7,42095,42095,(X),6.2,37677,37677,19971,53.0,19963,53.0,18876,50.1,5246,5246,3543,67.5,11300,11300,8315,73.6
42075,110484,110484,71158,64.4,70925,64.2,67157,60.8,3768,3.4,233,0.2,39326,35.6,70925,70925,(X),5.3,56895,56895,33305,58.5,33280,58.5,31603,55.5,9711,9711,6419,66.1,20598,20598,14954,72.6
42077,289854,289854,189318,65.3,189176,65.3,176888,61.0,12288,4.2,142,0.0,100536,34.7,189176,189176,(X),6.5,150395,150395,91420,60.8,91400,60.8,85164,56.6,24920,24920,18271,73.3,54320,54320,41336,76.1
42079,262908,262908,160370,61.0,160283,61.0,150246,57.1,10037,3.8,87,0.0,102538,39.0,160283,160283,(X),6.3,133899,133899,77189,57.6,77164,57.6,73103,54.6,18823,18823,13045,69.3,40320,40320,30537,75.7
42081,94029,94029,56713,60.3,56683,60.3,53722,57.1,2961,3.1,30,0.0,37316,39.7,56683,56683,(X),5.2,48320,48320,26755,55.4,26755,55.4,25478,52.7,7547,7547,5437,72.0,15197,15197,11609,76.4
42083,34548,34548,19611,56.8,19606,56.8,18267,52.9,1339,3.9,5,0.0,14937,43.2,19606,19606,(X),6.8,16815,16815,9265,55.1,9265,55.1,8678,51.6,2453,2453,1622,66.1,5107,5107,3830,75.0
42085,93525,93525,52386,56.0,52355,56.0,49595,53.0,2760,3.0,31,0.0,41139,44.0,52355,52355,(X),5.3,47816,47816,25022,52.3,25014,52.3,24029,50.3,6203,6203,4161,67.1,14353,14353,9976,69.5
42087,37231,37231,21871,58.7,21868,58.7,21081,56.6,787,2.1,3,0.0,15360,41.3,21868,21868,(X),3.6,19118,19118,10016,52.4,10016,52.4,9670,50.6,3109,3109,1726,55.5,6674,6674,4508,67.5
42089,138833,138833,85284,61.4,85210,61.4,78487,56.5,6723,4.8,74,0.1,53549,38.6,85210,85210,(X),7.9,70502,70502,40240,57.1,40219,57.0,36761,52.1,8615,8615,5672,65.8,23599,23599,15665,66.4
42091,663260,663260,452775,68.3,452489,68.2,431585,65.1,20904,3.2,286,0.0,210485,31.7,452489,452489,(X),4.6,344516,344516,218382,63.4,218349,63.4,208906,60.6,53984,53984,39391,73.0,119817,119817,91852,76.7
42093,15004,15004,8964,59.7,8961,59.7,8761,58.4,200,1.3,3,0.0,6040,40.3,8961,8961,(X),2.2,7858,7858,4074,51.8,4074,51.8,3954,50.3,1272,1272,833,65.5,2191,2191,1446,66.0
42095,248209,248209,157293,63.4,157256,63.4,148960,60.0,8296,3.3,37,0.0,90916,36.6,157256,157256,(X),5.3,127382,127382,74050,58.1,74050,58.1,70454,55.3,17448,17448,12708,72.8,40537,40537,30779,75.9
42097,76248,76248,43710,57.3,43675,57.3,41723,54.7,1952,2.6,35,0.0,32538,42.7,43675,43675,(X),4.5,38128,38128,20725,54.4,20721,54.3,20044,52.6,5489,5489,3867,70.4,11503,11503,8032,69.8
42099,37205,37205,23699,63.7,23673,63.6,22786,61.2,887,2.4,26,0.1,13506,36.3,23673,23673,(X),3.7,18624,18624,11048,59.3,11046,59.3,10578,56.8,3022,3022,1948,64.5,6514,6514,4427,68.0
42101,1265078,1265078,766771,60.6,766468,60.6,688298,54.4,78170,6.2,303,0.0,498307,39.4,766468,766468,(X),10.2,677081,677081,391924,57.9,391873,57.9,357714,52.8,119891,119891,85138,71.0,202138,202138,145136,71.8
42103,46878,46878,26930,57.4,26851,57.3,24860,53.0,1991,4.2,79,0.2,19948,42.6,26851,26851,(X),7.4,23349,23349,12241,52.4,12241,52.4,11372,48.7,2332,2332,1563,67.0,7407,7407,4815,65.0
42105,13824,13824,7101,51.4,7099,51.4,6631,48.0,468,3.4,2,0.0,6723,48.6,7099,7099,(X),6.6,6972,6972,3246,46.6,3246,46.6,3020,43.3,1071,1071,641,59.9,2345,2345,1580,67.4
42107,118578,118578,66911,56.4,66841,56.4,62675,52.9,4166,3.5,70,0.1,51667,43.6,66841,66841,(X),6.2,58047,58047,31152,53.7,31148,53.7,29281,50.4,8062,8062,5420,67.2,19175,19175,13476,70.3
42109,32912,32912,20764,63.1,20764,63.1,20196,61.4,568,1.7,0,0.0,12148,36.9,20764,20764,(X),2.7,16771,16771,9686,57.8,9686,57.8,9392,56.0,2486,2486,1360,54.7,5637,5637,3931,69.7
42111,62973,62973,34485,54.8,34480,54.8,32603,51.8,1877,3.0,5,0.0,28488,45.2,34480,34480,(X),5.4,29967,29967,15967,53.3,15967,53.3,15060,50.3,4172,4172,2889,69.2,8855,8855,6388,72.1
42113,5579,5579,2933,52.6,2933,52.6,2698,48.4,235,4.2,0,0.0,2646,47.4,2933,2933,(X),8.0,2635,2635,1275,48.4,1275,48.4,1199,45.5,228,228,116,50.9,401,401,311,77.6
42115,34539,34539,19452,56.3,19452,56.3,18265,52.9,1187,3.4,0,0.0,15087,43.7,19452,19452,(X),6.1,17233,17233,8861,51.4,8861,51.4,8404,48.8,2151,2151,1260,58.6,5200,5200,3482,67.0
42117,34019,34019,19227,56.5,19224,56.5,18091,53.2,1133,3.3,3,0.0,14792,43.5,19224,19224,(X),5.9,17206,17206,9009,52.4,9009,52.4,8573,49.8,2497,2497,1528,61.2,5186,5186,3829,73.8
42119,38167,38167,19003,49.8,18995,49.8,18296,47.9,699,1.8,8,0.0,19164,50.2,18995,18995,(X),3.7,16923,16923,8693,51.4,8685,51.3,8415,49.7,2375,2375,1528,64.3,5194,5194,3359,64.7
42121,43401,43401,24447,56.3,24446,56.3,22786,52.5,1660,3.8,1,0.0,18954,43.7,24446,24446,(X),6.8,22131,22131,11507,52.0,11507,52.0,10838,49.0,2910,2910,1921,66.0,6798,6798,4941,72.7
42123,33234,33234,19195,57.8,19191,57.7,18202,54.8,989,3.0,4,0.0,14039,42.2,19191,19191,(X),5.2,16674,16674,8941,53.6,8941,53.6,8608,51.6,2297,2297,1463,63.7,5032,5032,3599,71.5
42125,171723,171723,105240,61.3,105164,61.2,99783,58.1,5381,3.1,76,0.0,66483,38.7,105164,105164,(X),5.1,88262,88262,49699,56.3,49690,56.3,47531,53.9,12416,12416,9003,72.5,26750,26750,19798,74.0
42127,43835,43835,22566,51.5,22558,51.5,21197,48.4,1361,3.1,8,0.0,21269,48.5,22558,22558,(X),6.0,20528,20528,10256,50.0,10256,50.0,9700,47.3,2621,2621,1849,70.5,5783,5783,3828,66.2
42129,297011,297011,180872,60.9,180813,60.9,172824,58.2,7989,2.7,59,0.0,116139,39.1,180813,180813,(X),4.4,153095,153095,85576,55.9,85547,55.9,82146,53.7,18905,18905,13298,70.3,44426,44426,33254,74.9
42131,22829,22829,13775,60.3,13773,60.3,12971,56.8,802,3.5,2,0.0,9054,39.7,13773,13773,(X),5.8,11420,11420,6185,54.2,6185,54.2,5860,51.3,1594,1594,1068,67.0,3536,3536,2508,70.9
42133,356928,356928,234527,65.7,234271,65.6,222484,62.3,11787,3.3,256,0.1,122401,34.3,234271,234271,(X),5.0,182467,182467,111857,61.3,111830,61.3,106848,58.6,29888,29888,20990,70.2,64260,64260,47673,74.2
44001,40792,40792,26160,64.1,26105,64.0,25195,61.8,910,2.2,55,0.1,14632,35.9,26105,26105,(X),3.5,21296,21296,12926,60.7,12926,60.7,12537,58.9,2429,2429,1876,77.2,6574,6574,5110,77.7
44003,136538,136538,91821,67.2,91700,67.2,86754,63.5,4946,3.6,121,0.1,44717,32.8,91700,91700,(X),5.4,71326,71326,44432,62.3,44411,62.3,42386,59.4,9313,9313,7197,77.3,20982,20982,16210,77.3
44005,70272,70272,46264,65.8,43369,61.7,41378,58.9,1991,2.8,2895,4.1,24008,34.2,43369,43369,(X),4.6,35797,35797,21540,60.2,21152,59.1,20213,56.5,4220,4220,2978,70.6,9782,9782,7592,77.6
44007,518298,518298,332771,64.2,332522,64.2,310070,59.8,22452,4.3,249,0.0,185527,35.8,332522,332522,(X),6.8,269326,269326,163065,60.5,163007,60.5,152504,56.6,42311,42311,30607,72.3,83910,83910,63321,75.5
44009,107469,107469,68981,64.2,68755,64.0,64575,60.1,4180,3.9,226,0.2,38488,35.8,68755,68755,(X),6.1,55916,55916,33461,59.8,33435,59.8,31581,56.5,5500,5500,3991,72.6,15254,15254,12551,82.3
45001,20092,20092,10571,52.6,10548,52.5,9748,48.5,800,4.0,23,0.1,9521,47.4,10548,10548,(X),7.6,10517,10517,5151,49.0,5151,49.0,4777,45.4,1499,1499,935,62.4,3302,3302,2115,64.1
45003,134604,134604,77911,57.9,77562,57.6,71542,53.1,6020,4.5,349,0.3,56693,42.1,77562,77562,(X),7.8,70442,70442,37745,53.6,37734,53.6,34868,49.5,11299,11299,7244,64.1,23267,23267,16489,70.9
45005,7604,7604,3346,44.0,3346,44.0,2796,36.8,550,7.2,0,0.0,4258,56.0,3346,3346,(X),16.4,3518,3518,1692,48.1,1692,48.1,1480,42.1,478,478,321,67.2,1063,1063,942,88.6
45007,155982,155982,94000,60.3,93867,60.2,88386,56.7,5481,3.5,133,0.1,61982,39.7,93867,93867,(X),5.8,81817,81817,45225,55.3,45225,55.3,42319,51.7,12532,12532,7915,63.2,29469,29469,20736,70.4
45009,11887,11887,5769,48.5,5769,48.5,5433,45.7,336,2.8,0,0.0,6118,51.5,5769,5769,(X),5.8,6246,6246,2893,46.3,2893,46.3,2692,43.1,773,773,421,54.5,1842,1842,1284,69.7
45011,16907,16907,8964,53.0,8949,52.9,8235,48.7,714,4.2,15,0.1,7943,47.0,8949,8949,(X),8.0,8962,8962,4466,49.8,4466,49.8,4121,46.0,1442,1442,739,51.2,3248,3248,2101,64.7
45013,151365,151365,85467,56.5,79063,52.2,74418,49.2,4645,3.1,6404,4.2,65898,43.5,79063,79063,(X),5.9,77581,77581,39106,50.4,38307,49.4,36209,46.7,11928,11928,7566,63.4,21607,21607,15510,71.8
45015,163846,163846,106386,64.9,101750,62.1,96452,58.9,5298,3.2,4636,2.8,57460,35.1,101750,101750,(X),5.2,82767,82767,49410,59.7,48927,59.1,46374,56.0,16004,16004,10051,62.8,31399,31399,22359,71.2
45017,12263,12263,6823,55.6,6823,55.6,6388,52.1,435,3.5,0,0.0,5440,44.4,6823,6823,(X),6.4,6454,6454,3724,57.7,3724,57.7,3434,53.2,762,762,508,66.7,1900,1900,1176,61.9
45019,324123,324123,211901,65.4,209236,64.6,200094,61.7,9142,2.8,2665,0.8,112222,34.6,209236,209236,(X),4.4,169009,169009,104310,61.7,103783,61.4,99227,58.7,27405,27405,20029,73.1,47389,47389,35910,75.8
45021,45022,45022,23664,52.6,23664,52.6,22272,49.5,1392,3.1,0,0.0,21358,47.4,23664,23664,(X),5.9,23329,23329,11041,47.3,11041,47.3,10482,44.9,3534,3534,2163,61.2,8438,8438,5665,67.1
45023,25792,25792,14115,54.7,14107,54.7,13094,50.8,1013,3.9,8,0.0,11677,45.3,14107,14107,(X),7.2,13500,13500,6721,49.8,6721,49.8,6380,47.3,2226,2226,1477,66.4,4216,4216,3097,73.5
45025,36930,36930,20955,56.7,20930,56.7,18961,51.3,1969,5.3,25,0.1,15975,43.3,20930,20930,(X),9.4,18941,18941,9932,52.4,9932,52.4,8810,46.5,2870,2870,1793,62.5,6317,6317,4027,63.7
45027,28192,28192,13295,47.2,13295,47.2,11726,41.6,1569,5.6,0,0.0,14897,52.8,13295,13295,(X),11.8,14409,14409,6780,47.1,6780,47.1,5930,41.2,1864,1864,1213,65.1,4288,4288,3333,77.7
45029,30029,30029,17288,57.6,17178,57.2,15620,52.0,1558,5.2,110,0.4,12741,42.4,17178,17178,(X),9.1,15813,15813,8308,52.5,8245,52.1,7443,47.1,2400,2400,1658,69.1,5503,5503,4246,77.2
45031,53884,53884,30026,55.7,30026,55.7,26540,49.3,3486,6.5,0,0.0,23858,44.3,30026,30026,(X),11.6,28903,28903,15294,52.9,15294,52.9,13607,47.1,4528,4528,3419,75.5,9081,9081,6678,73.5
45033,23741,23741,12395,52.2,12390,52.2,11306,47.6,1084,4.6,5,0.0,11346,47.8,12390,12390,(X),8.7,12901,12901,6319,49.0,6314,48.9,5777,44.8,2292,2292,1332,58.1,5043,5043,3352,66.5
45035,121670,121670,78615,64.6,77483,63.7,73015,60.0,4468,3.7,1132,0.9,43055,35.4,77483,77483,(X),5.8,63421,63421,37816,59.6,37688,59.4,35402,55.8,11066,11066,7762,70.1,25681,25681,19236,74.9
45037,22525,22525,11255,50.0,11233,49.9,10489,46.6,744,3.3,22,0.1,11270,50.0,11233,11233,(X),6.6,10282,10282,5056,49.2,5040,49.0,4812,46.8,1218,1218,939,77.1,3357,3357,2307,68.7
45039,18885,18885,9388,49.7,9361,49.6,8626,45.7,735,3.9,27,0.1,9497,50.3,9361,9361,(X),7.9,9936,9936,4514,45.4,4508,45.4,4237,42.6,1038,1038,825,79.5,2974,2974,1624,54.6
45041,109043,109043,65758,60.3,65652,60.2,60509,55.5,5143,4.7,106,0.1,43285,39.7,65652,65652,(X),7.8,59339,59339,33879,57.1,33879,57.1,31218,52.6,10032,10032,7732,77.1,20604,20604,15993,77.6
45043,51479,51479,27222,52.9,27156,52.8,24850,48.3,2306,4.5,66,0.1,24257,47.1,27156,27156,(X),8.5,27526,27526,13425,48.8,13425,48.8,12414,45.1,3303,3303,2342,70.9,7840,7840,5790,73.9
45045,394981,394981,252795,64.0,252439,63.9,240453,60.9,11986,3.0,356,0.1,142186,36.0,252439,252439,(X),4.7,205799,205799,120093,58.4,120012,58.3,113974,55.4,36622,36622,22995,62.8,74371,74371,51759,69.6
45047,56099,56099,32825,58.5,32790,58.5,30079,53.6,2711,4.8,35,0.1,23274,41.5,32790,32790,(X),8.3,30383,30383,16553,54.5,16553,54.5,15162,49.9,4864,4864,3089,63.5,10218,10218,7587,74.3
45049,15957,15957,8433,52.8,8380,52.5,7552,47.3,828,5.2,53,0.3,7524,47.2,8380,8380,(X),9.9,7733,7733,3989,51.6,3989,51.6,3562,46.1,1131,1131,713,63.0,2791,2791,1962,70.3
45051,267807,267807,152165,56.8,152029,56.8,142291,53.1,9738,3.6,136,0.1,115642,43.2,152029,152029,(X),6.4,139876,139876,73410,52.5,73358,52.4,68723,49.1,17811,17811,12111,68.0,38440,38440,27675,72.0
45053,22387,22387,13439,60.0,13408,59.9,12182,54.4,1226,5.5,31,0.1,8948,40.0,13408,13408,(X),9.1,10965,10965,5924,54.0,5903,53.8,5472,49.9,2053,2053,1438,70.0,3544,3544,2495,70.4
45055,51187,51187,29394,57.4,29205,57.1,27280,53.3,1925,3.8,189,0.4,21793,42.6,29205,29205,(X),6.6,26915,26915,14358,53.3,14334,53.3,13396,49.8,4001,4001,2869,71.7,10262,10262,7342,71.5
45057,71909,71909,40995,57.0,40942,56.9,38181,53.1,2761,3.8,53,0.1,30914,43.0,40942,40942,(X),6.7,37188,37188,19912,53.5,19877,53.5,18274,49.1,6124,6124,4313,70.4,12468,12468,9020,72.3
45059,53700,53700,30562,56.9,30527,56.8,27963,52.1,2564,4.8,35,0.1,23138,43.1,30527,30527,(X),8.4,27979,27979,14804,52.9,14804,52.9,13523,48.3,4565,4565,3294,72.2,8905,8905,6272,70.4
45061,14425,14425,6400,44.4,6393,44.3,5850,40.6,543,3.8,7,0.0,8025,55.6,6393,6393,(X),8.5,7009,7009,3203,45.7,3196,45.6,2905,41.4,1006,1006,413,41.1,2014,2014,1328,65.9
45063,227132,227132,147615,65.0,147214,64.8,138852,61.1,8362,3.7,401,0.2,79517,35.0,147214,147214,(X),5.7,117647,117647,70670,60.1,70662,60.1,66329,56.4,20006,20006,13125,65.6,43714,43714,32909,75.3
45065,8570,8570,3032,35.4,3032,35.4,2633,30.7,399,4.7,0,0.0,5538,64.6,3032,3032,(X),13.2,3839,3839,1508,39.3,1508,39.3,1311,34.1,338,338,269,79.6,665,665,448,67.4
45067,25074,25074,12801,51.1,12794,51.0,11497,45.9,1297,5.2,7,0.0,12273,48.9,12794,12794,(X),10.1,13808,13808,6739,48.8,6739,48.8,6028,43.7,2044,2044,1251,61.2,4337,4337,3231,74.5
45069,22426,22426,11083,49.4,11047,49.3,9616,42.9,1431,6.4,36,0.2,11343,50.6,11047,11047,(X),13.0,10587,10587,5523,52.2,5523,52.2,4766,45.0,1622,1622,1201,74.0,3425,3425,2681,78.3
45071,30642,30642,17729,57.9,17729,57.9,16459,53.7,1270,4.1,0,0.0,12913,42.1,17729,17729,(X),7.2,15915,15915,8443,53.1,8443,53.1,7832,49.2,2718,2718,2110,77.6,5436,5436,3718,68.4
45073,62936,62936,33271,52.9,33248,52.8,31132,49.5,2116,3.4,23,0.0,29665,47.1,33248,33248,(X),6.4,32140,32140,15363,47.8,15363,47.8,14432,44.9,4557,4557,3186,69.9,9600,9600,6815,71.0
45075,71081,71081,38543,54.2,38529,54.2,34965,49.2,3564,5.0,14,0.0,32538,45.8,38529,38529,(X),9.3,38371,38371,19501,50.8,19498,50.8,17765,46.3,5482,5482,3661,66.8,12820,12820,9693,75.6
45077,102079,102079,57920,56.7,57895,56.7,54520,53.4,3375,3.3,25,0.0,44159,43.3,57895,57895,(X),5.8,51457,51457,26763,52.0,26763,52.0,25237,49.0,7025,7025,4322,61.5,14799,14799,10259,69.3
45079,330031,330031,220305,66.8,209230,63.4,194982,59.1,14248,4.3,11075,3.4,109726,33.2,209230,209230,(X),6.8,171400,171400,109268,63.8,106230,62.0,98990,57.8,27455,27455,20366,74.2,55535,55535,43415,78.2
45081,16295,16295,9384,57.6,9299,57.1,8745,53.7,554,3.4,85,0.5,6911,42.4,9299,9299,(X),6.0,8214,8214,4174,50.8,4120,50.2,3817,46.5,1461,1461,916,62.7,2733,2733,2103,76.9
45083,239693,239693,147346,61.5,147236,61.4,138787,57.9,8449,3.5,110,0.0,92347,38.5,147236,147236,(X),5.7,124866,124866,70947,56.8,70947,56.8,66639,53.4,20780,20780,14084,67.8,44669,44669,32090,71.8
45085,84043,84043,50295,59.8,47636,56.7,42568,50.7,5068,6.0,2659,3.2,33748,40.2,47636,47636,(X),10.6,44379,44379,24875,56.1,24316,54.8,21795,49.1,8000,8000,5696,71.2,16475,16475,11791,71.6
45087,22387,22387,12635,56.4,12580,56.2,11637,52.0,943,4.2,55,0.2,9752,43.6,12580,12580,(X),7.5,11907,11907,6248,52.5,6248,52.5,5612,47.1,1872,1872,1330,71.0,3438,3438,2680,78.0
45089,25928,25928,12679,48.9,12639,48.7,11712,45.2,927,3.6,40,0.2,13249,51.1,12639,12639,(X),7.3,13539,13539,6741,49.8,6741,49.8,6348,46.9,1581,1581,1322,83.6,4290,4290,2787,65.0
45091,202549,202549,135223,66.8,134940,66.6,126871,62.6,8069,4.0,283,0.1,67326,33.2,134940,134940,(X),6.0,106273,106273,64599,60.8,64553,60.7,60605,57.0,18589,18589,12586,67.7,42404,42404,31862,75.1
46003,2123,2123,1460,68.8,1460,68.8,1442,67.9,18,0.8,0,0.0,663,31.2,1460,1460,(X),1.2,1003,1003,630,62.8,630,62.8,618,61.6,251,251,228,90.8,414,414,381,92.0
46005,13970,13970,9481,67.9,9460,67.7,9298,66.6,162,1.2,21,0.2,4489,32.1,9460,9460,(X),1.7,6805,6805,4012,59.0,4003,58.8,3957,58.1,1741,1741,977,56.1,2794,2794,2154,77.1
46007,2345,2345,1388,59.2,1388,59.2,1224,52.2,164,7.0,0,0.0,957,40.8,1388,1388,(X),11.8,1270,1270,683,53.8,683,53.8,592,46.6,288,288,219,76.0,747,747,560,75.0
46009,5814,5814,2952,50.8,2951,50.8,2911,50.1,40,0.7,1,0.0,2862,49.2,2951,2951,(X),1.4,2312,2312,1410,61.0,1410,61.0,1380,59.7,357,357,297,83.2,856,856,710,82.9
46011,28060,28060,20077,71.6,20053,71.5,19359,69.0,694,2.5,24,0.1,7983,28.4,20053,20053,(X),3.5,13637,13637,9353,68.6,9353,68.6,8940,65.6,2423,2423,1744,72.0,4289,4289,3602,84.0
46013,30736,30736,21287,69.3,21248,69.1,20784,67.6,464,1.5,39,0.1,9449,30.7,21248,21248,(X),2.2,15778,15778,10316,65.4,10301,65.3,10019,63.5,2849,2849,2339,82.1,6214,6214,5003,80.5
46015,4112,4112,2820,68.6,2809,68.3,2752,66.9,57,1.4,11,0.3,1292,31.4,2809,2809,(X),2.0,2132,2132,1374,64.4,1374,64.4,1349,63.3,425,425,282,66.4,819,819,636,77.7
46017,1368,1368,803,58.7,803,58.7,658,48.1,145,10.6,0,0.0,565,41.3,803,803,(X),18.1,707,707,386,54.6,386,54.6,329,46.5,209,209,110,52.6,430,430,350,81.4
46019,8023,8023,5130,63.9,5130,63.9,4935,61.5,195,2.4,0,0.0,2893,36.1,5130,5130,(X),3.8,4026,4026,2385,59.2,2385,59.2,2361,58.6,700,700,372,53.1,1445,1445,1054,72.9
46021,1181,1181,734,62.2,734,62.2,727,61.6,7,0.6,0,0.0,447,37.8,734,734,(X),1.0,561,561,336,59.9,336,59.9,330,58.8,103,103,92,89.3,180,180,141,78.3
46023,6910,6910,4180,60.5,4180,60.5,3894,56.4,286,4.1,0,0.0,2730,39.5,4180,4180,(X),6.8,3475,3475,2014,58.0,2014,58.0,1882,54.2,876,876,614,70.1,1583,1583,1282,81.0
46025,2813,2813,1851,65.8,1851,65.8,1786,63.5,65,2.3,0,0.0,962,34.2,1851,1851,(X),3.5,1384,1384,778,56.2,778,56.2,777,56.1,397,397,238,59.9,475,475,322,67.8
46027,11711,11711,8135,69.5,8118,69.3,7645,65.3,473,4.0,17,0.1,3576,30.5,8118,8118,(X),5.8,6015,6015,4051,67.3,4051,67.3,3744,62.2,840,840,697,83.0,1494,1494,1042,69.7
46029,22130,22130,15731,71.1,15712,71.0,15309,69.2,403,1.8,19,0.1,6399,28.9,15712,15712,(X),2.6,11041,11041,7143,64.7,7143,64.7,6999,63.4,2143,2143,1759,82.1,4298,4298,3469,80.7
46031,2799,2799,1743,62.3,1743,62.3,1282,45.8,461,16.5,0,0.0,1056,37.7,1743,1743,(X),26.4,1390,1390,787,56.6,787,56.6,572,41.2,485,485,297,61.2,795,795,561,70.6
46033,7427,7427,4072,54.8,4067,54.8,3928,52.9,139,1.9,5,0.1,3355,45.2,4067,4067,(X),3.4,3751,3751,1831,48.8,1831,48.8,1759,46.9,368,368,240,65.2,763,763,614,80.5
46035,15843,15843,10893,68.8,10893,68.8,10568,66.7,325,2.1,0,0.0,4950,31.2,10893,10893,(X),3.0,7948,7948,5047,63.5,5047,63.5,4898,61.6,1338,1338,1063,79.4,2872,2872,2534,88.2
46037,4425,4425,2706,61.2,2706,61.2,2654,60.0,52,1.2,0,0.0,1719,38.8,2706,2706,(X),1.9,2151,2151,1172,54.5,1172,54.5,1152,53.6,321,321,196,61.1,794,794,650,81.9
46039,3411,3411,2331,68.3,2331,68.3,2284,67.0,47,1.4,0,0.0,1080,31.7,2331,2331,(X),2.0,1659,1659,1018,61.4,1018,61.4,997,60.1,313,313,257,82.1,646,646,541,83.7
46041,3856,3856,2614,67.8,2614,67.8,2036,52.8,578,15.0,0,0.0,1242,32.2,2614,2614,(X),22.1,2000,2000,1250,62.5,1250,62.5,1025,51.3,779,779,501,64.3,1044,1044,727,69.6
46043,2295,2295,1460,63.6,1460,63.6,1444,62.9,16,0.7,0,0.0,835,36.4,1460,1460,(X),1.1,1194,1194,698,58.5,698,58.5,689,57.7,238,238,155,65.1,380,380,301,79.2
46045,3098,3098,1984,64.0,1984,64.0,1933,62.4,51,1.6,0,0.0,1114,36.0,1984,1984,(X),2.6,1467,1467,850,57.9,850,57.9,846,57.7,295,295,208,70.5,616,616,492,79.9
46047,5751,5751,3263,56.7,3255,56.6,3197,55.6,58,1.0,8,0.1,2488,43.3,3255,3255,(X),1.8,2894,2894,1589,54.9,1589,54.9,1578,54.5,328,328,266,81.1,787,787,574,72.9
46049,1855,1855,1095,59.0,1094,59.0,1090,58.8,4,0.2,1,0.1,760,41.0,1094,1094,(X),0.4,969,969,527,54.4,527,54.4,527,54.4,229,229,215,93.9,272,272,219,80.5
46051,5807,5807,3753,64.6,3753,64.6,3716,64.0,37,0.6,0,0.0,2054,35.4,3753,3753,(X),1.0,2795,2795,1613,57.7,1613,57.7,1590,56.9,458,458,351,76.6,1088,1088,931,85.6
46053,3291,3291,2060,62.6,2054,62.4,2032,61.7,22,0.7,6,0.2,1231,37.4,2054,2054,(X),1.1,1640,1640,929,56.6,929,56.6,917,55.9,303,303,225,74.3,654,654,583,89.1
46055,1633,1633,959,58.7,959,58.7,934,57.2,25,1.5,0,0.0,674,41.3,959,959,(X),2.6,815,815,362,44.4,362,44.4,361,44.3,111,111,67,60.4,371,371,213,57.4
46057,4309,4309,2914,67.6,2914,67.6,2855,66.3,59,1.4,0,0.0,1395,32.4,2914,2914,(X),2.0,2103,2103,1275,60.6,1275,60.6,1265,60.2,610,610,386,63.3,1242,1242,896,72.1
46059,2659,2659,1780,66.9,1780,66.9,1767,66.5,13,0.5,0,0.0,879,33.1,1780,1780,(X),0.7,1303,1303,760,58.3,760,58.3,752,57.7,218,218,174,79.8,475,475,389,81.9
46061,2436,2436,1654,67.9,1649,67.7,1629,66.9,20,0.8,5,0.2,782,32.1,1649,1649,(X),1.2,1215,1215,759,62.5,759,62.5,743,61.2,323,323,255,78.9,713,713,553,77.6
46063,1078,1078,706,65.5,701,65.0,685,63.5,16,1.5,5,0.5,372,34.5,701,701,(X),2.3,504,504,292,57.9,292,57.9,282,56.0,96,96,65,67.7,179,179,118,65.9
46065,13883,13883,9524,68.6,9524,68.6,9323,67.2,201,1.4,0,0.0,4359,31.4,9524,9524,(X),2.1,7173,7173,4475,62.4,4475,62.4,4425,61.7,1587,1587,1209,76.2,2251,2251,2101,93.3
46067,5747,5747,3818,66.4,3818,66.4,3669,63.8,149,2.6,0,0.0,1929,33.6,3818,3818,(X),3.9,2904,2904,1739,59.9,1739,59.9,1715,59.1,619,619,410,66.2,1070,1070,953,89.1
46069,1098,1098,681,62.0,681,62.0,668,60.8,13,1.2,0,0.0,417,38.0,681,681,(X),1.9,549,549,269,49.0,269,49.0,266,48.5,77,77,58,75.3,160,160,131,81.9
46071,2355,2355,1117,47.4,1117,47.4,1023,43.4,94,4.0,0,0.0,1238,52.6,1117,1117,(X),8.4,1180,1180,570,48.3,570,48.3,537,45.5,412,412,197,47.8,573,573,306,53.4
46073,1630,1630,976,59.9,976,59.9,973,59.7,3,0.2,0,0.0,654,40.1,976,976,(X),0.3,862,862,455,52.8,455,52.8,455,52.8,139,139,106,76.3,290,290,211,72.8
46075,651,651,431,66.2,431,66.2,410,63.0,21,3.2,0,0.0,220,33.8,431,431,(X),4.9,318,318,206,64.8,206,64.8,196,61.6,17,17,8,47.1,84,84,30,35.7
46077,3982,3982,2693,67.6,2691,67.6,2670,67.1,21,0.5,2,0.1,1289,32.4,2691,2691,(X),0.8,1952,1952,1204,61.7,1204,61.7,1193,61.1,362,362,285,78.7,705,705,560,79.4
46079,10279,10279,7051,68.6,7036,68.5,6737,65.5,299,2.9,15,0.1,3228,31.4,7036,7036,(X),4.2,4899,4899,3241,66.2,3241,66.2,3082,62.9,881,881,823,93.4,1504,1504,1362,90.6
46081,21266,21266,14024,65.9,13964,65.7,13595,63.9,369,1.7,60,0.3,7242,34.1,13964,13964,(X),2.6,10620,10620,6698,63.1,6698,63.1,6555,61.7,1284,1284,902,70.2,2946,2946,2366,80.3
46083,40461,40461,30726,75.9,30652,75.8,29972,74.1,680,1.7,74,0.2,9735,24.1,30652,30652,(X),2.2,20809,20809,14904,71.6,14904,71.6,14614,70.2,5010,5010,3902,77.9,10279,10279,8426,82.0
46085,2881,2881,1885,65.4,1885,65.4,1759,61.1,126,4.4,0,0.0,996,34.6,1885,1885,(X),6.7,1386,1386,865,62.4,865,62.4,801,57.8,345,345,297,86.1,647,647,485,75.0
46087,4183,4183,3031,72.5,3025,72.3,2909,69.5,116,2.8,6,0.1,1152,27.5,3025,3025,(X),3.8,2122,2122,1427,67.2,1427,67.2,1359,64.0,475,475,426,89.7,949,949,780,82.2
46089,1941,1941,1123,57.9,1123,57.9,1032,53.2,91,4.7,0,0.0,818,42.1,1123,1123,(X),8.1,953,953,503,52.8,503,52.8,495,51.9,169,169,131,77.5,303,303,217,71.6
46091,3735,3735,2527,67.7,2527,67.7,2488,66.6,39,1.0,0,0.0,1208,32.3,2527,2527,(X),1.5,1756,1756,1114,63.4,1114,63.4,1100,62.6,490,490,383,78.2,756,756,652,86.2
46093,21472,21472,15373,71.6,14282,66.5,14081,65.6,201,0.9,1091,5.1,6099,28.4,14282,14282,(X),1.4,10249,10249,6595,64.3,6486,63.3,6386,62.3,2123,2123,1514,71.3,4100,4100,3206,78.2
46095,1441,1441,624,43.3,624,43.3,573,39.8,51,3.5,0,0.0,817,56.7,624,624,(X),8.2,690,690,287,41.6,287,41.6,272,39.4,177,177,90,50.8,382,382,201,52.6
46097,1719,1719,1146,66.7,1144,66.6,1114,64.8,30,1.7,2,0.1,573,33.3,1144,1144,(X),2.6,834,834,517,62.0,517,62.0,514,61.6,161,161,112,69.6,404,404,342,84.7
46099,144283,144283,108132,74.9,107899,74.8,104419,72.4,3480,2.4,233,0.2,36151,25.1,107899,107899,(X),3.2,72069,72069,51311,71.2,51283,71.2,49810,69.1,16367,16367,12673,77.4,28526,28526,23984,84.1
46101,5032,5032,3417,67.9,3417,67.9,3263,64.8,154,3.1,0,0.0,1615,32.1,3417,3417,(X),4.5,2497,2497,1578,63.2,1578,63.2,1493,59.8,453,453,371,81.9,988,988,729,73.8
46102,9630,9630,4320,44.9,4320,44.9,3469,36.0,851,8.8,0,0.0,5310,55.1,4320,4320,(X),19.7,5042,5042,2029,40.2,2029,40.2,1734,34.4,1515,1515,683,45.1,2704,2704,1439,53.2
46103,86121,86121,57782,67.1,56835,66.0,54687,63.5,2148,2.5,947,1.1,28339,32.9,56835,56835,(X),3.8,43083,43083,27148,63.0,27058,62.8,25977,60.3,8255,8255,6215,75.3,15119,15119,12269,81.1
46105,2361,2361,1629,69.0,1629,69.0,1577,66.8,52,2.2,0,0.0,732,31.0,1629,1629,(X),3.2,1154,1154,742,64.3,742,64.3,731,63.3,227,227,167,73.6,375,375,348,92.8
46107,1866,1866,1137,60.9,1137,60.9,1128,60.5,9,0.5,0,0.0,729,39.1,1137,1137,(X),0.8,944,944,507,53.7,507,53.7,505,53.5,190,190,152,80.0,312,312,251,80.4
46109,7781,7781,5026,64.6,5025,64.6,4718,60.6,307,3.9,1,0.0,2755,35.4,5025,5025,(X),6.1,3815,3815,2483,65.1,2483,65.1,2337,61.3,902,902,707,78.4,1753,1753,1467,83.7
46111,1928,1928,1350,70.0,1325,68.7,1283,66.5,42,2.2,25,1.3,578,30.0,1325,1325,(X),3.2,946,946,631,66.7,631,66.7,605,64.0,224,224,175,78.1,301,301,228,75.7
46115,5187,5187,3323,64.1,3320,64.0,3247,62.6,73,1.4,3,0.1,1864,35.9,3320,3320,(X),2.2,2617,2617,1526,58.3,1526,58.3,1500,57.3,417,417,338,81.1,1044,1044,872,83.5
46117,2295,2295,1749,76.2,1730,75.4,1702,74.2,28,1.2,19,0.8,546,23.8,1730,1730,(X),1.6,1115,1115,832,74.6,832,74.6,813,72.9,250,250,250,100.0,487,487,465,95.5
46119,1048,1048,685,65.4,685,65.4,681,65.0,4,0.4,0,0.0,363,34.6,685,685,(X),0.6,505,505,279,55.2,279,55.2,279,55.2,57,57,57,100.0,245,245,245,100.0
46121,6474,6474,2967,45.8,2967,45.8,2576,39.8,391,6.0,0,0.0,3507,54.2,2967,2967,(X),13.2,3321,3321,1556,46.9,1556,46.9,1381,41.6,1298,1298,735,56.6,2100,2100,1301,62.0
46123,4338,4338,2885,66.5,2885,66.5,2783,64.2,102,2.4,0,0.0,1453,33.5,2885,2885,(X),3.5,2191,2191,1297,59.2,1297,59.2,1244,56.8,383,383,301,78.6,750,750,568,75.7
46125,6512,6512,4352,66.8,4352,66.8,4243,65.2,109,1.7,0,0.0,2160,33.2,4352,4352,(X),2.5,3281,3281,1988,60.6,1988,60.6,1958,59.7,590,590,415,70.3,1310,1310,1077,82.2
46127,11997,11997,8249,68.8,8225,68.6,8074,67.3,151,1.3,24,0.2,3748,31.2,8225,8225,(X),1.8,5984,5984,3696,61.8,3680,61.5,3594,60.1,1051,1051,692,65.8,2469,2469,2040,82.6
46129,4388,4388,2862,65.2,2832,64.5,2753,62.7,79,1.8,30,0.7,1526,34.8,2832,2832,(X),2.8,2181,2181,1272,58.3,1272,58.3,1233,56.5,387,387,269,69.5,808,808,584,72.3
46135,18399,18399,11781,64.0,11750,63.9,11387,61.9,363,2.0,31,0.2,6618,36.0,11750,11750,(X),3.1,8819,8819,5492,62.3,5492,62.3,5403,61.3,1598,1598,1313,82.2,3109,3109,2607,83.9
46137,2005,2005,1338,66.7,1338,66.7,1029,51.3,309,15.4,0,0.0,667,33.3,1338,1338,(X),23.1,966,966,614,63.6,614,63.6,533,55.2,245,245,107,43.7,551,551,378,68.6
47001,61591,61591,35100,57.0,35100,57.0,32986,53.6,2114,3.4,0,0.0,26491,43.0,35100,35100,(X),6.0,31891,31891,16398,51.4,16398,51.4,15301,48.0,4306,4306,2860,66.4,10572,10572,7622,72.1
47003,36605,36605,22861,62.5,22856,62.4,21679,59.2,1177,3.2,5,0.0,13744,37.5,22856,22856,(X),5.1,18800,18800,10651,56.7,10651,56.7,10035,53.4,3653,3653,2284,62.5,7316,7316,4883,66.7
47005,13385,13385,6114,45.7,6106,45.6,5627,42.0,479,3.6,8,0.1,7271,54.3,6106,6106,(X),7.8,6931,6931,2961,42.7,2961,42.7,2724,39.3,837,837,580,69.3,2062,2062,1283,62.2
47007,12521,12521,6340,50.6,6325,50.5,5739,45.8,586,4.7,15,0.1,6181,49.4,6325,6325,(X),9.3,5088,5088,2134,41.9,2134,41.9,1987,39.1,653,653,293,44.9,1414,1414,858,60.7
47009,105517,105517,63061,59.8,62987,59.7,59749,56.6,3238,3.1,74,0.1,42456,40.2,62987,62987,(X),5.1,54822,54822,30013,54.7,29985,54.7,28393,51.8,7639,7639,4701,61.5,16964,16964,11372,67.0
47011,84063,84063,50927,60.6,50875,60.5,47838,56.9,3037,3.6,52,0.1,33136,39.4,50875,50875,(X),6.0,43658,43658,23510,53.9,23500,53.8,22108,50.6,6905,6905,3975,57.6,14423,14423,9846,68.3
47013,32419,32419,16753,51.7,16729,51.6,15286,47.2,1443,4.5,24,0.1,15666,48.3,16729,16729,(X),8.6,16781,16781,8119,48.4,8108,48.3,7450,44.4,2311,2311,1395,60.4,4849,4849,3266,67.4
47015,11333,11333,6629,58.5,6611,58.3,6286,55.5,325,2.9,18,0.2,4704,41.5,6611,6611,(X),4.9,5679,5679,2871,50.6,2853,50.2,2663,46.9,934,934,611,65.4,1927,1927,1188,61.7
47017,22711,22711,11583,51.0,11583,51.0,10892,48.0,691,3.0,0,0.0,11128,49.0,11583,11583,(X),6.0,11878,11878,5601,47.2,5601,47.2,5156,43.4,2040,2040,1385,67.9,3651,3651,2284,62.6
47019,47111,47111,24342,51.7,24334,51.7,23008,48.8,1326,2.8,8,0.0,22769,48.3,24334,24334,(X),5.4,24263,24263,11367,46.8,11359,46.8,10820,44.6,2839,2839,1575,55.5,6888,6888,4078,59.2
47021,32014,32014,20578,64.3,20547,64.2,19619,61.3,928,2.9,31,0.1,11436,35.7,20547,20547,(X),4.5,16209,16209,9479,58.5,9479,58.5,8923,55.0,2433,2433,1658,68.1,5736,5736,4359,76.0
47023,13910,13910,7597,54.6,7554,54.3,6840,49.2,714,5.1,43,0.3,6313,45.4,7554,7554,(X),9.5,7378,7378,3827,51.9,3827,51.9,3409,46.2,1225,1225,773,63.1,2371,2371,1528,64.4
47025,26313,26313,13013,49.5,12984,49.3,11877,45.1,1107,4.2,29,0.1,13300,50.5,12984,12984,(X),8.5,13601,13601,6117,45.0,6117,45.0,5658,41.6,1748,1748,1030,58.9,3829,3829,2748,71.8
47027,6311,6311,2843,45.0,2843,45.0,2717,43.1,126,2.0,0,0.0,3468,55.0,2843,2843,(X),4.4,3236,3236,1353,41.8,1353,41.8,1289,39.8,454,454,375,82.6,949,949,629,66.3
47029,28957,28957,15530,53.6,15530,53.6,13973,48.3,1557,5.4,0,0.0,13427,46.4,15530,15530,(X),10.0,15136,15136,7694,50.8,7694,50.8,7004,46.3,1889,1889,1203,63.7,4697,4697,3198,68.1
47031,43063,43063,25287,58.7,25179,58.5,23796,55.3,1383,3.2,108,0.3,17776,41.3,25179,25179,(X),5.5,22371,22371,11593,51.8,11591,51.8,10734,48.0,3932,3932,2275,57.9,8294,8294,5118,61.7
47033,11369,11369,6423,56.5,6418,56.5,6085,53.5,333,2.9,5,0.0,4946,43.5,6418,6418,(X),5.2,5955,5955,3008,50.5,3008,50.5,2869,48.2,993,993,665,67.0,2264,2264,1540,68.0
47035,49297,49297,22941,46.5,22932,46.5,21382,43.4,1550,3.1,9,0.0,26356,53.5,22932,22932,(X),6.8,25355,25355,10476,41.3,10476,41.3,9577,37.8,2992,2992,1847,61.7,6533,6533,4701,72.0
47037,552221,552221,391774,70.9,391360,70.9,373294,67.6,18066,3.3,414,0.1,160447,29.1,391360,391360,(X),4.6,289070,289070,192046,66.4,191937,66.4,182429,63.1,53067,53067,35600,67.1,84628,84628,59712,70.6
47039,9417,9417,4939,52.4,4925,52.3,4486,47.6,439,4.7,14,0.1,4478,47.6,4925,4925,(X),8.9,4848,4848,2222,45.8,2222,45.8,2007,41.4,642,642,407,63.4,1665,1665,1205,72.4
47041,15835,15835,8359,52.8,8359,52.8,7931,50.1,428,2.7,0,0.0,7476,47.2,8359,8359,(X),5.1,8049,8049,3739,46.5,3739,46.5,3543,44.0,1247,1247,764,61.3,2439,2439,1188,48.7
47043,41190,41190,23774,57.7,23764,57.7,22818,55.4,946,2.3,10,0.0,17416,42.3,23764,23764,(X),4.0,21304,21304,11309,53.1,11309,53.1,10728,50.4,3595,3595,2097,58.3,7761,7761,5038,64.9
47045,29517,29517,17321,58.7,17309,58.6,15976,54.1,1333,4.5,12,0.0,12196,41.3,17309,17309,(X),7.7,15526,15526,8413,54.2,8413,54.2,7789,50.2,2512,2512,1843,73.4,5699,5699,4270,74.9
47047,32766,32766,18936,57.8,18909,57.7,17629,53.8,1280,3.9,27,0.1,13830,42.2,18909,18909,(X),6.8,16679,16679,8402,50.4,8402,50.4,7758,46.5,2414,2414,1689,70.0,5035,5035,3443,68.4
47049,14472,14472,7137,49.3,7137,49.3,6640,45.9,497,3.4,0,0.0,7335,50.7,7137,7137,(X),7.0,7369,7369,3240,44.0,3240,44.0,3045,41.3,1056,1056,552,52.3,2461,2461,1402,57.0
47051,34060,34060,19104,56.1,19080,56.0,18194,53.4,886,2.6,24,0.1,14956,43.9,19080,19080,(X),4.6,17525,17525,8892,50.7,8892,50.7,8460,48.3,2338,2338,1564,66.9,5245,5245,4022,76.7
47053,38814,38814,21426,55.2,21266,54.8,19867,51.2,1399,3.6,160,0.4,17388,44.8,21266,21266,(X),6.6,20500,20500,10389,50.7,10371,50.6,9779,47.7,3589,3589,2382,66.4,7477,7477,5320,71.2
47055,23777,23777,13114,55.2,13095,55.1,12294,51.7,801,3.4,19,0.1,10663,44.8,13095,13095,(X),6.1,12278,12278,6091,49.6,6091,49.6,5706,46.5,1965,1965,1200,61.1,3782,3782,2519,66.6
47057,18882,18882,10318,54.6,10318,54.6,9651,51.1,667,3.5,0,0.0,8564,45.4,10318,10318,(X),6.5,9609,9609,4680,48.7,4680,48.7,4363,45.4,1052,1052,668,63.5,3071,3071,2037,66.3
47059,57048,57048,30224,53.0,30210,53.0,28254,49.5,1956,3.4,14,0.0,26824,47.0,30210,30210,(X),6.5,29389,29389,14858,50.6,14858,50.6,14095,48.0,3677,3677,2461,66.9,8228,8228,6085,74.0
47061,10743,10743,5202,48.4,5199,48.4,4756,44.3,443,4.1,3,0.0,5541,51.6,5199,5199,(X),8.5,5542,5542,2342,42.3,2342,42.3,2174,39.2,867,867,555,64.0,1803,1803,1016,56.4
47063,50675,50675,28448,56.1,28377,56.0,26125,51.6,2252,4.4,71,0.1,22227,43.9,28377,28377,(X),7.9,26024,26024,13549,52.1,13549,52.1,12395,47.6,4063,4063,2649,65.2,9015,9015,5699,63.2
47065,291022,291022,180190,61.9,179763,61.8,169798,58.3,9965,3.4,427,0.1,110832,38.1,179763,179763,(X),5.5,152576,152576,86736,56.8,86711,56.8,81637,53.5,23841,23841,15567,65.3,47519,47519,34030,71.6
47067,5388,5388,2506,46.5,2506,46.5,2295,42.6,211,3.9,0,0.0,2882,53.5,2506,2506,(X),8.4,2705,2705,1181,43.7,1181,43.7,1102,40.7,365,365,193,52.9,839,839,588,70.1
47069,21109,21109,9252,43.8,9250,43.8,8021,38.0,1229,5.8,2,0.0,11857,56.2,9250,9250,(X),13.3,9278,9278,4499,48.5,4499,48.5,3969,42.8,1170,1170,678,57.9,3435,3435,2441,71.1
47071,21079,21079,10607,50.3,10600,50.3,9760,46.3,840,4.0,7,0.0,10472,49.7,10600,10600,(X),7.9,10747,10747,4800,44.7,4800,44.7,4364,40.6,1442,1442,1108,76.8,3496,3496,2092,59.8
47073,46143,46143,23676,51.3,23670,51.3,22014,47.7,1656,3.6,6,0.0,22467,48.7,23670,23670,(X),7.0,23775,23775,11320,47.6,11320,47.6,10644,44.8,2822,2822,1741,61.7,7112,7112,4392,61.8
47075,14192,14192,8243,58.1,8238,58.0,7648,53.9,590,4.2,5,0.0,5949,41.9,8238,8238,(X),7.2,7654,7654,4160,54.4,4160,54.4,3879,50.7,1075,1075,852,79.3,2587,2587,1930,74.6
47077,22177,22177,12266,55.3,12266,55.3,11310,51.0,956,4.3,0,0.0,9911,44.7,12266,12266,(X),7.8,11563,11563,5922,51.2,5922,51.2,5384,46.6,1649,1649,1210,73.4,4362,4362,2937,67.3
47079,26325,26325,13420,51.0,13335,50.7,12437,47.2,898,3.4,85,0.3,12905,49.0,13335,13335,(X),6.7,13646,13646,6353,46.6,6353,46.6,5927,43.4,1954,1954,1189,60.8,4392,4392,2760,62.8
47081,20095,20095,10286,51.2,10278,51.1,9771,48.6,507,2.5,8,0.0,9809,48.8,10278,10278,(X),4.9,9516,9516,4758,50.0,4758,50.0,4555,47.9,1331,1331,768,57.7,3582,3582,2325,64.9
47083,6617,6617,3175,48.0,3175,48.0,2990,45.2,185,2.8,0,0.0,3442,52.0,3175,3175,(X),5.8,3379,3379,1365,40.4,1365,40.4,1247,36.9,508,508,247,48.6,1233,1233,770,62.4
47085,14971,14971,7641,51.0,7628,51.0,7140,47.7,488,3.3,13,0.1,7330,49.0,7628,7628,(X),6.4,7746,7746,3605,46.5,3605,46.5,3290,42.5,1061,1061,523,49.3,2398,2398,1515,63.2
47087,9760,9760,4707,48.2,4707,48.2,4335,44.4,372,3.8,0,0.0,5053,51.8,4707,4707,(X),7.9,4929,4929,2212,44.9,2212,44.9,2086,42.3,571,571,321,56.2,1281,1281,799,62.4
47089,43766,43766,24402,55.8,24342,55.6,22913,52.4,1429,3.3,60,0.1,19364,44.2,24342,24342,(X),5.9,22452,22452,11710,52.2,11710,52.2,11102,49.4,2644,2644,1507,57.0,6915,6915,4726,68.3
47091,15193,15193,6073,40.0,6039,39.7,5810,38.2,229,1.5,34,0.2,9120,60.0,6039,6039,(X),3.8,6868,6868,2969,43.2,2969,43.2,2838,41.3,768,768,359,46.7,1696,1696,1188,70.0
47093,370217,370217,238642,64.5,238383,64.4,226894,61.3,11489,3.1,259,0.1,131575,35.5,238383,238383,(X),4.8,192493,192493,112977,58.7,112951,58.7,107284,55.7,30575,30575,19542,63.9,61080,61080,44415,72.7
47095,6563,6563,2208,33.6,2208,33.6,1991,30.3,217,3.3,0,0.0,4355,66.4,2208,2208,(X),9.8,2340,2340,1161,49.6,1161,49.6,1064,45.5,355,355,258,72.7,599,599,374,62.4
47097,20992,20992,10243,48.8,10225,48.7,9376,44.7,849,4.0,18,0.1,10749,51.2,10225,10225,(X),8.3,10196,10196,5101,50.0,5101,50.0,4731,46.4,1697,1697,1197,70.5,3874,3874,2877,74.3
47099,33430,33430,17663,52.8,17663,52.8,16131,48.3,1532,4.6,0,0.0,15767,47.2,17663,17663,(X),8.7,17229,17229,7999,46.4,7999,46.4,7288,42.3,3373,3373,1903,56.4,6731,6731,4045,60.1
47101,9581,9581,5133,53.6,5133,53.6,4941,51.6,192,2.0,0,0.0,4448,46.4,5133,5133,(X),3.7,4968,4968,2580,51.9,2580,51.9,2467,49.7,709,709,582,82.1,1711,1711,1151,67.3
47103,27139,27139,15438,56.9,15427,56.8,14678,54.1,749,2.8,11,0.0,11701,43.1,15427,15427,(X),4.9,13901,13901,6695,48.2,6695,48.2,6347,45.7,1930,1930,1329,68.9,5018,5018,2999,59.8
47105,42654,42654,21837,51.2,21833,51.2,20653,48.4,1180,2.8,4,0.0,20817,48.8,21833,21833,(X),5.4,21982,21982,10168,46.3,10168,46.3,9504,43.2,3460,3460,1687,48.8,5996,5996,3989,66.5
47107,42660,42660,22747,53.3,22723,53.3,21141,49.6,1582,3.7,24,0.1,19913,46.7,22723,22723,(X),7.0,22241,22241,10761,48.4,10761,48.4,9927,44.6,3332,3332,2275,68.3,7026,7026,4501,64.1
47109,20930,20930,10600,50.6,10582,50.6,9278,44.3,1304,6.2,18,0.1,10330,49.4,10582,10582,(X),12.3,10794,10794,4827,44.7,4827,44.7,4281,39.7,1592,1592,915,57.5,3635,3635,2336,64.3
47111,18415,18415,10687,58.0,10687,58.0,10215,55.5,472,2.6,0,0.0,7728,42.0,10687,10687,(X),4.4,9493,9493,4868,51.3,4868,51.3,4597,48.4,1927,1927,1333,69.2,3394,3394,2103,62.0
47113,78191,78191,45913,58.7,45881,58.7,43519,55.7,2362,3.0,32,0.0,32278,41.3,45881,45881,(X),5.1,41913,41913,23049,55.0,23025,54.9,21799,52.0,7083,7083,4730,66.8,14139,14139,10061,71.2
47115,23226,23226,13098,56.4,13080,56.3,12401,53.4,679,2.9,18,0.1,10128,43.6,13080,13080,(X),5.2,12007,12007,5858,48.8,5858,48.8,5491,45.7,1827,1827,1104,60.4,3564,3564,2334,65.5
47117,25612,25612,15257,59.6,15246,59.5,14297,55.8,949,3.7,11,0.0,10355,40.4,15246,15246,(X),6.2,13184,13184,6956,52.8,6956,52.8,6396,48.5,2089,2089,1409,67.4,5096,5096,3680,72.2
47119,70862,70862,44360,62.6,44329,62.6,42042,59.3,2287,3.2,31,0.0,26502,37.4,44329,44329,(X),5.2,37362,37362,21293,57.0,21293,57.0,20112,53.8,6828,6828,4990,73.1,13225,13225,10336,78.2
47121,9740,9740,4944,50.8,4944,50.8,4480,46.0,464,4.8,0,0.0,4796,49.2,4944,4944,(X),9.4,4886,4886,2171,44.4,2171,44.4,1953,40.0,670,670,453,67.6,1520,1520,1011,66.5
47123,37211,37211,18772,50.4,18764,50.4,17042,45.8,1722,4.6,8,0.0,18439,49.6,18764,18764,(X),9.2,19012,19012,8692,45.7,8692,45.7,7880,41.4,2770,2770,1728,62.4,5860,5860,4174,71.2
47125,148439,148439,98713,66.5,86151,58.0,80066,53.9,6085,4.1,12562,8.5,49726,33.5,86151,86151,(X),7.1,74790,74790,44156,59.0,42961,57.4,39387,52.7,18924,18924,10738,56.7,31918,31918,20016,62.7
47127,5228,5228,2925,55.9,2899,55.5,2763,52.9,136,2.6,26,0.5,2303,44.1,2899,2899,(X),4.7,2720,2720,1276,46.9,1276,46.9,1235,45.4,431,431,212,49.2,803,803,563,70.1
47129,17997,17997,7868,43.7,7865,43.7,7263,40.4,602,3.3,3,0.0,10129,56.3,7865,7865,(X),7.7,7806,7806,3640,46.6,3640,46.6,3304,42.3,1018,1018,507,49.8,2393,2393,1480,61.8
47131,24582,24582,13625,55.4,13610,55.4,12747,51.9,863,3.5,15,0.1,10957,44.6,13610,13610,(X),6.3,12868,12868,6612,51.4,6612,51.4,6097,47.4,1916,1916,1494,78.0,4413,4413,3024,68.5
47133,17748,17748,9358,52.7,9358,52.7,8982,50.6,376,2.1,0,0.0,8390,47.3,9358,9358,(X),4.0,9143,9143,4451,48.7,4451,48.7,4296,47.0,1330,1330,744,55.9,3331,3331,2198,66.0
47135,6418,6418,3044,47.4,3044,47.4,2790,43.5,254,4.0,0,0.0,3374,52.6,3044,3044,(X),8.3,3220,3220,1439,44.7,1439,44.7,1296,40.2,605,605,301,49.8,1033,1033,528,51.1
47137,4267,4267,2130,49.9,2130,49.9,2042,47.9,88,2.1,0,0.0,2137,50.1,2130,2130,(X),4.1,2134,2134,962,45.1,962,45.1,918,43.0,269,269,174,64.7,518,518,311,60.0
47139,13845,13845,7466,53.9,7466,53.9,6859,49.5,607,4.4,0,0.0,6379,46.1,7466,7466,(X),8.1,6991,6991,3466,49.6,3466,49.6,3136,44.9,865,865,605,69.9,2248,2248,1345,59.8
47141,62403,62403,35907,57.5,35821,57.4,33590,53.8,2231,3.6,86,0.1,26496,42.5,35821,35821,(X),6.2,31694,31694,16974,53.6,16971,53.5,16170,51.0,5048,5048,3253,64.4,10148,10148,7308,72.0
47143,25852,25852,14317,55.4,14317,55.4,13217,51.1,1100,4.3,0,0.0,11535,44.6,14317,14317,(X),7.7,13189,13189,6601,50.0,6601,50.0,6141,46.6,2206,2206,1485,67.3,4515,4515,3272,72.5
47145,44320,44320,23089,52.1,23034,52.0,21345,48.2,1689,3.8,55,0.1,21231,47.9,23034,23034,(X),7.3,22787,22787,10556,46.3,10556,46.3,10100,44.3,2558,2558,1539,60.2,6260,6260,3663,58.5
47147,54465,54465,35721,65.6,35653,65.5,33524,61.6,2129,3.9,68,0.1,18744,34.4,35653,35653,(X),6.0,27844,27844,16541,59.4,16541,59.4,15478,55.6,4720,4720,3094,65.6,11200,11200,8322,74.3
47149,239032,239032,169949,71.1,169438,70.9,161242,67.5,8196,3.4,511,0.2,69083,28.9,169438,169438,(X),4.8,122440,122440,80142,65.5,80050,65.4,76434,62.4,23240,23240,15383,66.2,50119,50119,37376,74.6
47151,17269,17269,9105,52.7,9105,52.7,8290,48.0,815,4.7,0,0.0,8164,47.3,9105,9105,(X),9.0,8814,8814,4407,50.0,4407,50.0,4039,45.8,1563,1563,940,60.1,3164,3164,2339,73.9
47153,12053,12053,6279,52.1,6279,52.1,5929,49.2,350,2.9,0,0.0,5774,47.9,6279,6279,(X),5.6,6137,6137,2877,46.9,2877,46.9,2680,43.7,782,782,335,42.8,2111,2111,1186,56.2
47155,78721,78721,49147,62.4,49040,62.3,46263,58.8,2777,3.5,107,0.1,29574,37.6,49040,49040,(X),5.7,40770,40770,24031,58.9,24031,58.9,22726,55.7,6241,6241,4526,72.5,12404,12404,9383,75.6
47157,727049,727049,469854,64.6,468378,64.4,432142,59.4,36236,5.0,1476,0.2,257195,35.4,468378,468378,(X),7.7,387263,387263,235244,60.7,235004,60.7,216699,56.0,75149,75149,50731,67.5,149242,149242,109928,73.7
47159,15502,15502,9125,58.9,9125,58.9,8792,56.7,333,2.1,0,0.0,6377,41.1,9125,9125,(X),3.6,7901,7901,4338,54.9,4338,54.9,4160,52.7,1266,1266,801,63.3,2934,2934,2072,70.6
47161,10892,10892,5714,52.5,5625,51.6,5222,47.9,403,3.7,89,0.8,5178,47.5,5625,5625,(X),7.2,5525,5525,2677,48.5,2677,48.5,2614,47.3,819,819,470,57.4,1807,1807,1232,68.2
47163,129597,129597,70417,54.3,70391,54.3,66020,50.9,4371,3.4,26,0.0,59180,45.7,70391,70391,(X),6.2,67390,67390,33188,49.2,33188,49.2,31487,46.7,8769,8769,5209,59.4,19747,19747,12464,63.1
47165,141527,141527,94023,66.4,93808,66.3,90151,63.7,3657,2.6,215,0.2,47504,33.6,93808,93808,(X),3.9,73167,73167,44833,61.3,44816,61.3,42910,58.6,12768,12768,8899,69.7,27899,27899,21170,75.9
47167,47959,47959,29749,62.0,29545,61.6,27266,56.9,2279,4.8,204,0.4,18210,38.0,29545,29545,(X),7.7,24802,24802,13855,55.9,13837,55.8,12825,51.7,4340,4340,3054,70.4,9905,9905,6911,69.8
47169,7853,7853,4486,57.1,4486,57.1,4051,51.6,435,5.5,0,0.0,3367,42.9,4486,4486,(X),9.7,3486,3486,2040,58.5,2040,58.5,1910,54.8,605,605,472,78.0,1160,1160,872,75.2
47171,15012,15012,7788,51.9,7781,51.8,7063,47.0,718,4.8,7,0.0,7224,48.1,7781,7781,(X),9.2,7561,7561,3413,45.1,3413,45.1,3147,41.6,739,739,393,53.2,2093,2093,1398,66.8
47173,15564,15564,7885,50.7,7885,50.7,7209,46.3,676,4.3,0,0.0,7679,49.3,7885,7885,(X),8.6,7882,7882,3727,47.3,3727,47.3,3450,43.8,1091,1091,621,56.9,2584,2584,1463,56.6
47175,4760,4760,2441,51.3,2441,51.3,2153,45.2,288,6.1,0,0.0,2319,48.7,2441,2441,(X),11.8,2379,2379,1140,47.9,1140,47.9,1034,43.5,332,332,181,54.5,653,653,457,70.0
47177,31999,31999,18014,56.3,17994,56.2,16895,52.8,1099,3.4,20,0.1,13985,43.7,17994,17994,(X),6.1,16365,16365,8187,50.0,8187,50.0,7478,45.7,2806,2806,1386,49.4,6054,6054,3893,64.3
47179,105133,105133,61693,58.7,61683,58.7,58720,55.9,2963,2.8,10,0.0,43440,41.3,61683,61683,(X),4.8,54398,54398,29532,54.3,29532,54.3,28147,51.7,7414,7414,4547,61.3,16146,16146,11691,72.4
47181,13869,13869,6229,44.9,6201,44.7,5753,41.5,448,3.2,28,0.2,7640,55.1,6201,6201,(X),7.2,6211,6211,3035,48.9,3035,48.9,2824,45.5,1036,1036,654,63.1,1814,1814,1230,67.8
47183,27910,27910,15225,54.6,15217,54.5,14302,51.2,915,3.3,8,0.0,12685,45.4,15217,15217,(X),6.0,14420,14420,7228,50.1,7228,50.1,6787,47.1,1998,1998,1164,58.3,4087,4087,2855,69.9
47185,21227,21227,10966,51.7,10957,51.6,10087,47.5,870,4.1,9,0.0,10261,48.3,10957,10957,(X),7.9,11057,11057,5188,46.9,5188,46.9,4711,42.6,1717,1717,884,51.5,3773,3773,2314,61.3
47187,165632,165632,114252,69.0,114160,68.9,110383,66.6,3777,2.3,92,0.1,51380,31.0,114160,114160,(X),3.3,85651,85651,50965,59.5,50959,59.5,49054,57.3,16052,16052,9686,60.3,43221,43221,27308,63.2
47189,104566,104566,68910,65.9,68760,65.8,66073,63.2,2687,2.6,150,0.1,35656,34.1,68760,68760,(X),3.9,53759,53759,32373,60.2,32373,60.2,31132,57.9,9269,9269,6213,67.0,20710,20710,15464,74.7
48001,47868,47868,19877,41.5,19865,41.5,19206,40.1,659,1.4,12,0.0,27991,58.5,19865,19865,(X),3.3,17721,17721,8899,50.2,8899,50.2,8576,48.4,3223,3223,2174,67.5,7317,7317,5345,73.0
48003,12916,12916,8625,66.8,8625,66.8,8221,63.6,404,3.1,0,0.0,4291,33.2,8625,8625,(X),4.7,6357,6357,3585,56.4,3585,56.4,3356,52.8,1738,1738,874,50.3,3570,3570,2408,67.5
48005,67561,67561,38913,57.6,38864,57.5,35779,53.0,3085,4.6,49,0.1,28648,42.4,38864,38864,(X),7.9,34872,34872,18126,52.0,18088,51.9,17014,48.8,6793,6793,3923,57.8,14568,14568,10299,70.7
48007,20752,20752,10919,52.6,10919,52.6,10195,49.1,724,3.5,0,0.0,9833,47.4,10919,10919,(X),6.6,10553,10553,4852,46.0,4852,46.0,4459,42.3,1249,1249,1016,81.3,3000,3000,1934,64.5
48009,7178,7178,4550,63.4,4542,63.3,4385,61.1,157,2.2,8,0.1,2628,36.6,4542,4542,(X),3.5,3637,3637,2033,55.9,2033,55.9,1940,53.3,490,490,427,87.1,1378,1378,1084,78.7
48011,1570,1570,960,61.1,960,61.1,951,60.6,9,0.6,0,0.0,610,38.9,960,960,(X),0.9,789,789,420,53.2,420,53.2,416,52.7,121,121,90,74.4,267,267,234,87.6
48013,36551,36551,21822,59.7,21796,59.6,20037,54.8,1759,4.8,26,0.1,14729,40.3,21796,21796,(X),8.1,18403,18403,9535,51.8,9535,51.8,8651,47.0,4012,4012,1752,43.7,8930,8930,6562,73.5
48015,23354,23354,14475,62.0,14475,62.0,13801,59.1,674,2.9,0,0.0,8879,38.0,14475,14475,(X),4.7,11825,11825,6551,55.4,6551,55.4,6243,52.8,2219,2219,1326,59.8,4714,4714,3277,69.5
48017,5294,5294,3347,63.2,3347,63.2,3273,61.8,74,1.4,0,0.0,1947,36.8,3347,3347,(X),2.2,2567,2567,1366,53.2,1366,53.2,1309,51.0,599,599,311,51.9,1282,1282,867,67.6
48019,18438,18438,9853,53.4,9850,53.4,9243,50.1,607,3.3,3,0.0,8585,46.6,9850,9850,(X),6.2,9405,9405,4856,51.6,4856,51.6,4613,49.0,1076,1076,652,60.6,2516,2516,1837,73.0
48021,63738,63738,37556,58.9,37547,58.9,35049,55.0,2498,3.9,9,0.0,26182,41.1,37547,37547,(X),6.7,31221,31221,16948,54.3,16948,54.3,15880,50.9,5958,5958,3450,57.9,13631,13631,9020,66.2
48023,2895,2895,1542,53.3,1542,53.3,1505,52.0,37,1.3,0,0.0,1353,46.7,1542,1542,(X),2.4,1516,1516,668,44.1,668,44.1,660,43.5,192,192,172,89.6,550,550,498,90.5
48025,26632,26632,10374,39.0,10374,39.0,9449,35.5,925,3.5,0,0.0,16258,61.0,10374,10374,(X),8.9,9856,9856,4802,48.7,4802,48.7,4471,45.4,2111,2111,1153,54.6,4519,4519,2444,54.1
48027,256437,256437,169037,65.9,150793,58.8,139158,54.3,11635,4.5,18244,7.1,87400,34.1,150793,150793,(X),7.7,128925,128925,76398,59.3,74063,57.4,67878,52.6,33424,33424,20290,60.7,57228,57228,37656,65.8
48029,1481694,1481694,957753,64.6,941816,63.6,887464,59.9,54352,3.7,15937,1.1,523941,35.4,941816,941816,(X),5.8,757682,757682,446061,58.9,442095,58.3,416262,54.9,160010,160010,98591,61.6,315577,315577,213258,67.6
48031,9446,9446,5670,60.0,5664,60.0,5343,56.6,321,3.4,6,0.1,3776,40.0,5664,5664,(X),5.7,4705,4705,2576,54.8,2576,54.8,2461,52.3,503,503,359,71.4,1443,1443,1165,80.7
48033,522,522,284,54.4,284,54.4,278,53.3,6,1.1,0,0.0,238,45.6,284,284,(X),2.1,273,273,114,41.8,114,41.8,111,40.7,94,94,42,44.7,75,75,58,77.3
48035,14645,14645,7917,54.1,7917,54.1,7563,51.6,354,2.4,0,0.0,6728,45.9,7917,7917,(X),4.5,7536,7536,3491,46.3,3491,46.3,3341,44.3,1135,1135,747,65.8,2512,2512,1794,71.4
48037,73924,73924,39772,53.8,39723,53.7,37085,50.2,2638,3.6,49,0.1,34152,46.2,39723,39723,(X),6.6,36855,36855,19237,52.2,19224,52.2,18020,48.9,6752,6752,4403,65.2,13744,13744,9977,72.6
48039,270297,270297,173459,64.2,173351,64.1,165147,61.1,8204,3.0,108,0.0,96838,35.8,173351,173351,(X),4.7,134363,134363,77929,58.0,77884,58.0,74232,55.2,29641,29641,19073,64.3,60894,60894,42891,70.4
48041,178862,178862,109836,61.4,109653,61.3,104813,58.6,4840,2.7,183,0.1,69026,38.6,109653,109653,(X),4.4,88189,88189,51287,58.2,51251,58.1,49292,55.9,15653,15653,9480,60.6,27607,27607,20155,73.0
48043,7647,7647,4515,59.0,4515,59.0,4318,56.5,197,2.6,0,0.0,3132,41.0,4515,4515,(X),4.4,3849,3849,2094,54.4,2094,54.4,2012,52.3,525,525,290,55.2,1035,1035,751,72.6
48045,1291,1291,730,56.5,730,56.5,690,53.4,40,3.1,0,0.0,561,43.5,730,730,(X),5.5,587,587,277,47.2,277,47.2,268,45.7,80,80,65,81.3,176,176,132,75.0
48047,5538,5538,2843,51.3,2843,51.3,2428,43.8,415,7.5,0,0.0,2695,48.7,2843,2843,(X),14.6,2624,2624,1150,43.8,1150,43.8,1097,41.8,498,498,250,50.2,1189,1189,882,74.2
48049,30294,30294,16635,54.9,16635,54.9,15974,52.7,661,2.2,0,0.0,13659,45.1,16635,16635,(X),4.0,15422,15422,8017,52.0,8017,52.0,7751,50.3,2490,2490,1682,67.6,5326,5326,3553,66.7
48051,14331,14331,8229,57.4,8229,57.4,7731,53.9,498,3.5,0,0.0,6102,42.6,8229,8229,(X),6.1,7269,7269,3520,48.4,3520,48.4,3344,46.0,1086,1086,725,66.8,2417,2417,1579,65.3
48053,36874,36874,21283,57.7,21262,57.7,20303,55.1,959,2.6,21,0.1,15591,42.3,21262,21262,(X),4.5,18903,18903,9844,52.1,9844,52.1,9417,49.8,2694,2694,1866,69.3,6594,6594,4521,68.6
48055,32787,32787,18842,57.5,18842,57.5,18334,55.9,508,1.5,0,0.0,13945,42.5,18842,18842,(X),2.7,16387,16387,8356,51.0,8356,51.0,8085,49.3,3152,3152,1615,51.2,6187,6187,4445,71.8
48057,17008,17008,10360,60.9,10348,60.8,9606,56.5,742,4.4,12,0.1,6648,39.1,10348,10348,(X),7.2,8333,8333,4594,55.1,4594,55.1,4195,50.3,1672,1672,1035,61.9,3493,3493,2489,71.3
48059,10949,10949,5884,53.7,5878,53.7,5684,51.9,194,1.8,6,0.1,5065,46.3,5878,5878,(X),3.3,5584,5584,2565,45.9,2565,45.9,2473,44.3,860,860,535,62.2,2133,2133,1298,60.9
48061,305790,305790,168814,55.2,168689,55.2,157501,51.5,11188,3.7,125,0.0,136976,44.8,168689,168689,(X),6.6,160099,160099,79058,49.4,79045,49.4,74330,46.4,41205,41205,21839,53.0,82069,82069,46383,56.5
48063,9802,9802,5586,57.0,5586,57.0,5239,53.4,347,3.5,0,0.0,4216,43.0,5586,5586,(X),6.2,5136,5136,2678,52.1,2678,52.1,2487,48.4,1104,1104,725,65.7,2152,2152,1361,63.2
48065,4696,4696,2965,63.1,2965,63.1,2897,61.7,68,1.4,0,0.0,1731,36.9,2965,2965,(X),2.3,2487,2487,1396,56.1,1396,56.1,1331,53.5,435,435,277,63.7,993,993,701,70.6
48067,23951,23951,12520,52.3,12520,52.3,11615,48.5,905,3.8,0,0.0,11431,47.7,12520,12520,(X),7.2,12609,12609,5986,47.5,5986,47.5,5544,44.0,1796,1796,1239,69.0,4263,4263,2963,69.5
48069,5773,5773,3512,60.8,3512,60.8,3438,59.6,74,1.3,0,0.0,2261,39.2,3512,3512,(X),2.1,2864,2864,1417,49.5,1417,49.5,1387,48.4,748,748,267,35.7,1439,1439,941,65.4
48071,30211,30211,18989,62.9,18976,62.8,17821,59.0,1155,3.8,13,0.0,11222,37.1,18976,18976,(X),6.1,14976,14976,7549,50.4,7549,50.4,7105,47.4,3088,3088,1663,53.9,7558,7558,4963,65.7
48073,40159,40159,21530,53.6,21530,53.6,20364,50.7,1166,2.9,0,0.0,18629,46.4,21530,21530,(X),5.4,19669,19669,9910,50.4,9910,50.4,9434,48.0,4243,4243,2643,62.3,8276,8276,5476,66.2
48075,6035,6035,3147,52.1,3147,52.1,2801,46.4,346,5.7,0,0.0,2888,47.9,3147,3147,(X),11.0,2135,2135,1148,53.8,1148,53.8,1052,49.3,366,366,196,53.6,915,915,652,71.3
48077,8487,8487,4678,55.1,4678,55.1,4355,51.3,323,3.8,0,0.0,3809,44.9,4678,4678,(X),6.9,4300,4300,2172,50.5,2172,50.5,2066,48.0,514,514,305,59.3,1499,1499,959,64.0
48079,2189,2189,1290,58.9,1290,58.9,1207,55.1,83,3.8,0,0.0,899,41.1,1290,1290,(X),6.4,1084,1084,535,49.4,535,49.4,505,46.6,249,249,125,50.2,443,443,300,67.7
48081,2700,2700,1457,54.0,1457,54.0,1411,52.3,46,1.7,0,0.0,1243,46.0,1457,1457,(X),3.2,1385,1385,688,49.7,688,49.7,659,47.6,86,86,73,84.9,473,473,397,83.9
48083,6809,6809,3461,50.8,3461,50.8,3348,49.2,113,1.7,0,0.0,3348,49.2,3461,3461,(X),3.3,3355,3355,1403,41.8,1403,41.8,1349,40.2,557,557,331,59.4,1121,1121,751,67.0
48085,722702,722702,512621,70.9,512045,70.9,492047,68.1,19998,2.8,576,0.1,210081,29.1,512045,512045,(X),3.9,371201,371201,233825,63.0,233630,62.9,224010,60.3,72174,72174,43992,61.0,172902,172902,118302,68.4
48087,2317,2317,1446,62.4,1446,62.4,1322,57.1,124,5.4,0,0.0,871,37.6,1446,1446,(X),8.6,1195,1195,676,56.6,676,56.6,566,47.4,201,201,120,59.7,498,498,242,48.6
48089,16585,16585,9832,59.3,9832,59.3,9489,57.2,343,2.1,0,0.0,6753,40.7,9832,9832,(X),3.5,8399,8399,4365,52.0,4365,52.0,4294,51.1,1482,1482,961,64.8,3204,3204,2347,73.3
48091,107898,107898,64715,60.0,64339,59.6,61977,57.4,2362,2.2,376,0.3,43183,40.0,64339,64339,(X),3.7,55214,55214,29307,53.1,29166,52.8,27983,50.7,8967,8967,5314,59.3,20447,20447,12652,61.9
48093,10783,10783,5812,53.9,5812,53.9,5638,52.3,174,1.6,0,0.0,4971,46.1,5812,5812,(X),3.0,5442,5442,2480,45.6,2480,45.6,2382,43.8,929,929,547,58.9,1925,1925,1154,59.9
48095,3755,3755,1260,33.6,1260,33.6,1245,33.2,15,0.4,0,0.0,2495,66.4,1260,1260,(X),1.2,1270,1270,597,47.0,597,47.0,582,45.8,152,152,119,78.3,381,381,276,72.4
48097,31186,31186,20106,64.5,20106,64.5,19101,61.2,1005,3.2,0,0.0,11080,35.5,20106,20106,(X),5.0,15836,15836,9169,57.9,9169,57.9,8601,54.3,2881,2881,2025,70.3,5824,5824,4399,75.5
48099,59308,59308,33680,56.8,25694,43.3,23340,39.4,2354,4.0,7986,13.5,25628,43.2,25694,25694,(X),9.2,29817,29817,13636,45.7,12971,43.5,11605,38.9,6183,6183,3290,53.2,10615,10615,6532,61.5
48101,1144,1144,716,62.6,716,62.6,655,57.3,61,5.3,0,0.0,428,37.4,716,716,(X),8.5,615,615,335,54.5,335,54.5,289,47.0,184,184,168,91.3,344,344,301,87.5
48103,3481,3481,2056,59.1,2056,59.1,2029,58.3,27,0.8,0,0.0,1425,40.9,2056,2056,(X),1.3,1714,1714,695,40.5,695,40.5,680,39.7,427,427,180,42.2,950,950,559,58.8
48105,2800,2800,1741,62.2,1741,62.2,1741,62.2,0,0.0,0,0.0,1059,37.8,1741,1741,(X),0.0,1389,1389,759,54.6,759,54.6,759,54.6,285,285,150,52.6,532,532,358,67.3
48107,4427,4427,2634,59.5,2634,59.5,2443,55.2,191,4.3,0,0.0,1793,40.5,2634,2634,(X),7.3,2240,2240,1145,51.1,1145,51.1,1042,46.5,439,439,313,71.3,1114,1114,890,79.9
48109,1772,1772,1051,59.3,1051,59.3,983,55.5,68,3.8,0,0.0,721,40.7,1051,1051,(X),6.5,830,830,390,47.0,390,47.0,379,45.7,213,213,146,68.5,282,282,246,87.2
48111,5191,5191,3770,72.6,3770,72.6,3623,69.8,147,2.8,0,0.0,1421,27.4,3770,3770,(X),3.9,2453,2453,1561,63.6,1561,63.6,1469,59.9,740,740,501,67.7,1483,1483,1017,68.6
48113,1970439,1970439,1354603,68.7,1353911,68.7,1282839,65.1,71072,3.6,692,0.0,615836,31.3,1353911,1353911,(X),5.2,1009495,1009495,621148,61.5,620945,61.5,584930,57.9,224713,224713,137429,61.2,430407,430407,290031,67.4
48115,10238,10238,5147,50.3,5147,50.3,4863,47.5,284,2.8,0,0.0,5091,49.7,5147,5147,(X),5.5,4420,4420,2364,53.5,2364,53.5,2173,49.2,904,904,690,76.3,1948,1948,1402,72.0
48117,13577,13577,9002,66.3,8999,66.3,8581,63.2,418,3.1,3,0.0,4575,33.7,8999,8999,(X),4.6,6799,6799,3783,55.6,3783,55.6,3506,51.6,1920,1920,1178,61.4,3808,3808,2777,72.9
48119,4156,4156,2176,52.4,2176,52.4,2060,49.6,116,2.8,0,0.0,1980,47.6,2176,2176,(X),5.3,2083,2083,911,43.7,911,43.7,882,42.3,321,321,229,71.3,819,819,558,68.1
48121,625739,625739,456060,72.9,455705,72.8,436490,69.8,19215,3.1,355,0.1,169679,27.1,455705,455705,(X),4.2,321219,321219,213759,66.5,213736,66.5,204509,63.7,61465,61465,39943,65.0,137289,137289,98996,72.1
48123,16250,16250,8574,52.8,8490,52.2,7957,49.0,533,3.3,84,0.5,7676,47.2,8490,8490,(X),6.3,7709,7709,3773,48.9,3689,47.9,3574,46.4,1607,1607,1044,65.0,2624,2624,1715,65.4
48125,1810,1810,879,48.6,879,48.6,743,41.0,136,7.5,0,0.0,931,51.4,879,879,(X),15.5,876,876,387,44.2,387,44.2,346,39.5,103,103,37,35.9,354,354,239,67.5
48127,7910,7910,4227,53.4,4227,53.4,3533,44.7,694,8.8,0,0.0,3683,46.6,4227,4227,(X),16.4,4208,4208,1972,46.9,1972,46.9,1806,42.9,1151,1151,828,71.9,1830,1830,1523,83.2
48129,2756,2756,1521,55.2,1521,55.2,1487,54.0,34,1.2,0,0.0,1235,44.8,1521,1521,(X),2.2,1410,1410,695,49.3,695,49.3,679,48.2,206,206,108,52.4,426,426,348,81.7
48131,8662,8662,4555,52.6,4555,52.6,4073,47.0,482,5.6,0,0.0,4107,47.4,4555,4555,(X),10.6,4181,4181,2075,49.6,2075,49.6,1857,44.4,880,880,523,59.4,1929,1929,1244,64.5
48133,14920,14920,6892,46.2,6890,46.2,6531,43.8,359,2.4,2,0.0,8028,53.8,6890,6890,(X),5.2,7486,7486,3162,42.2,3162,42.2,3058,40.8,1093,1093,526,48.1,2337,2337,1365,58.4
48135,115517,115517,78931,68.3,78917,68.3,73658,63.8,5259,4.6,14,0.0,36586,31.7,78917,78917,(X),6.7,57032,57032,32382,56.8,32382,56.8,29890,52.4,16329,16329,9475,58.0,28581,28581,19654,68.8
48137,1740,1740,941,54.1,941,54.1,902,51.8,39,2.2,0,0.0,799,45.9,941,941,(X),4.1,873,873,468,53.6,468,53.6,429,49.1,142,142,124,87.3,183,183,130,71.0
48139,128446,128446,85088,66.2,85034,66.2,81964,63.8,3070,2.4,54,0.0,43358,33.8,85034,85034,(X),3.6,66211,66211,39461,59.6,39461,59.6,38128,57.6,12961,12961,7740,59.7,30337,30337,20869,68.8
48141,631619,631619,390218,61.8,372771,59.0,348062,55.1,24709,3.9,17447,2.8,241401,38.2,372771,372771,(X),6.6,325108,325108,176664,54.3,174647,53.7,162542,50.0,73992,73992,42730,57.7,147637,147637,96485,65.4
48143,33777,33777,20287,60.1,20287,60.1,19604,58.0,683,2.0,0,0.0,13490,39.9,20287,20287,(X),3.4,17454,17454,9263,53.1,9263,53.1,9002,51.6,2788,2788,1446,51.9,5484,5484,3730,68.0
48145,14055,14055,6201,44.1,6195,44.1,5809,41.3,386,2.7,6,0.0,7854,55.9,6195,6195,(X),6.2,7583,7583,2830,37.3,2830,37.3,2551,33.6,1222,1222,675,55.2,2270,2270,1354,59.6
48147,27748,27748,14133,50.9,14120,50.9,13461,48.5,659,2.4,13,0.0,13615,49.1,14120,14120,(X),4.7,12995,12995,6615,50.9,6615,50.9,6292,48.4,2039,2039,1207,59.2,4698,4698,3161,67.3
48149,20507,20507,11397,55.6,11397,55.6,11209,54.7,188,0.9,0,0.0,9110,44.4,11397,11397,(X),1.6,10561,10561,5334,50.5,5334,50.5,5234,49.6,1610,1610,1133,70.4,3313,3313,2440,73.6
48151,3189,3189,1832,57.4,1832,57.4,1715,53.8,117,3.7,0,0.0,1357,42.6,1832,1832,(X),6.4,1645,1645,792,48.1,792,48.1,740,45.0,273,273,179,65.6,473,473,314,66.4
48153,4459,4459,2564,57.5,2564,57.5,2400,53.8,164,3.7,0,0.0,1895,42.5,2564,2564,(X),6.4,2288,2288,1065,46.5,1065,46.5,1016,44.4,429,429,218,50.8,1048,1048,690,65.8
48155,1194,1194,714,59.8,714,59.8,642,53.8,72,6.0,0,0.0,480,40.2,714,714,(X),10.1,562,562,314,55.9,314,55.9,297,52.8,62,62,51,82.3,172,172,97,56.4
48157,557828,557828,373257,66.9,372869,66.8,353205,63.3,19664,3.5,388,0.1,184571,33.1,372869,372869,(X),5.3,287247,287247,170816,59.5,170778,59.5,162096,56.4,60027,60027,37592,62.6,139494,139494,95666,68.6
48159,8455,8455,5029,59.5,5029,59.5,4654,55.0,375,4.4,0,0.0,3426,40.5,5029,5029,(X),7.5,4315,4315,2336,54.1,2336,54.1,2117,49.1,738,738,435,58.9,1808,1808,1608,88.9
48161,15762,15762,7722,49.0,7697,48.8,7273,46.1,424,2.7,25,0.2,8040,51.0,7697,7697,(X),5.5,7544,7544,3493,46.3,3493,46.3,3234,42.9,1382,1382,881,63.7,2924,2924,2058,70.4
48163,15437,15437,7228,46.8,7228,46.8,6757,43.8,471,3.1,0,0.0,8209,53.2,7228,7228,(X),6.5,5935,5935,2596,43.7,2596,43.7,2387,40.2,1276,1276,789,61.8,2380,2380,1654,69.5
48165,13582,13582,8691,64.0,8691,64.0,8273,60.9,418,3.1,0,0.0,4891,36.0,8691,8691,(X),4.8,6656,6656,3149,47.3,3149,47.3,2958,44.4,2630,2630,907,34.5,4434,4434,2180,49.2
48167,256124,256124,163994,64.0,163434,63.8,153139,59.8,10295,4.0,560,0.2,92130,36.0,163434,163434,(X),6.3,131039,131039,75515,57.6,75432,57.6,70290,53.6,24202,24202,15919,65.8,52360,52360,37706,72.0
48169,5438,5438,2205,40.5,2205,40.5,2134,39.2,71,1.3,0,0.0,3233,59.5,2205,2205,(X),3.2,1820,1820,1023,56.2,1023,56.2,1023,56.2,331,331,188,56.8,634,634,433,68.3
48171,21681,21681,12465,57.5,12442,57.4,11911,54.9,531,2.4,23,0.1,9216,42.5,12442,12442,(X),4.3,11381,11381,5956,52.3,5956,52.3,5711,50.2,1485,1485,1068,71.9,3484,3484,2456,70.5
48173,1130,1130,694,61.4,694,61.4,694,61.4,0,0.0,0,0.0,436,38.6,694,694,(X),0.0,553,553,227,41.0,227,41.0,227,41.0,68,68,49,72.1,230,230,170,73.9
48175,6127,6127,3279,53.5,3265,53.3,3075,50.2,190,3.1,14,0.2,2848,46.5,3265,3265,(X),5.8,3092,3092,1589,51.4,1589,51.4,1469,47.5,396,396,173,43.7,1144,1144,800,69.9
48177,15627,15627,9495,60.8,9495,60.8,9083,58.1,412,2.6,0,0.0,6132,39.2,9495,9495,(X),4.3,7871,7871,4244,53.9,4244,53.9,3939,50.0,1768,1768,933,52.8,3500,3500,2559,73.1
48179,17413,17413,9880,56.7,9861,56.6,9264,53.2,597,3.4,19,0.1,7533,43.3,9861,9861,(X),6.1,8083,8083,4158,51.4,4158,51.4,3945,48.8,1847,1847,1139,61.7,3402,3402,2535,74.5
48181,101316,101316,62680,61.9,62559,61.7,59160,58.4,3399,3.4,121,0.1,38636,38.1,62559,62559,(X),5.4,52534,52534,29382,55.9,29382,55.9,27767,52.9,8830,8830,5599,63.4,19774,19774,14082,71.2
48183,95016,95016,58399,61.5,58384,61.4,55553,58.5,2831,3.0,15,0.0,36617,38.5,58384,58384,(X),4.8,49428,49428,27073,54.8,27073,54.8,25995,52.6,10877,10877,7042,64.7,19486,19486,13099,67.2
48185,22062,22062,11107,50.3,11107,50.3,10583,48.0,524,2.4,0,0.0,10955,49.7,11107,11107,(X),4.7,9931,9931,5221,52.6,5221,52.6,4998,50.3,1646,1646,941,57.2,4090,4090,2334,57.1
48187,119740,119740,76329,63.7,75113,62.7,72170,60.3,2943,2.5,1216,1.0,43411,36.3,75113,75113,(X),3.9,60937,60937,35009,57.5,34779,57.1,33576,55.1,11656,11656,6820,58.5,26102,26102,18815,72.1
48189,25703,25703,15170,59.0,15170,59.0,14154,55.1,1016,4.0,0,0.0,10533,41.0,15170,15170,(X),6.7,12162,12162,6584,54.1,6584,54.1,6281,51.6,2864,2864,1978,69.1,5938,5938,4086,68.8
48191,2447,2447,1383,56.5,1383,56.5,1236,50.5,147,6.0,0,0.0,1064,43.5,1383,1383,(X),10.6,1249,1249,634,50.8,634,50.8,573,45.9,146,146,102,69.9,494,494,365,73.9
48193,6734,6734,3638,54.0,3627,53.9,3583,53.2,44,0.7,11,0.2,3096,46.0,3627,3627,(X),1.2,3411,3411,1624,47.6,1624,47.6,1615,47.3,495,495,207,41.8,1043,1043,779,74.7
48195,4125,4125,2404,58.3,2396,58.1,2286,55.4,110,2.7,8,0.2,1721,41.7,2396,2396,(X),4.6,2130,2130,938,44.0,938,44.0,879,41.3,493,493,217,44.0,1090,1090,508,46.6
48197,3120,3120,1807,57.9,1807,57.9,1674,53.7,133,4.3,0,0.0,1313,42.1,1807,1807,(X),7.4,1604,1604,885,55.2,885,55.2,833,51.9,205,205,152,74.1,590,590,409,69.3
48199,43960,43960,24599,56.0,24555,55.9,23565,53.6,990,2.3,44,0.1,19361,44.0,24555,24555,(X),4.0,22576,22576,10666,47.2,10666,47.2,10248,45.4,4304,4304,2525,58.7,8816,8816,5374,61.0
48201,3493070,3493070,2368055,67.8,2366473,67.7,2223265,63.6,143208,4.1,1582,0.0,1125015,32.2,2366473,2366473,(X),6.1,1770307,1770307,1050877,59.4,1050590,59.3,984795,55.6,406140,406140,237130,58.4,782109,782109,512613,65.5
48203,51650,51650,30011,58.1,29923,57.9,28251,54.7,1672,3.2,88,0.2,21639,41.9,29923,29923,(X),5.6,26770,26770,14122,52.8,14079,52.6,13309,49.7,5153,5153,2915,56.6,10944,10944,7653,69.9
48205,4665,4665,2032,43.6,2032,43.6,2013,43.2,19,0.4,0,0.0,2633,56.4,2032,2032,(X),0.9,1816,1816,1050,57.8,1050,57.8,1033,56.9,382,382,258,67.5,831,831,550,66.2
48207,4862,4862,2522,51.9,2522,51.9,2268,46.6,254,5.2,0,0.0,2340,48.1,2522,2522,(X),10.1,2238,2238,1024,45.8,1024,45.8,912,40.8,284,284,162,57.0,721,721,525,72.8
48209,161718,161718,109855,67.9,109560,67.7,103747,64.2,5813,3.6,295,0.2,51863,32.1,109560,109560,(X),5.3,81767,81767,50858,62.2,50858,62.2,48102,58.8,14788,14788,9537,64.5,30473,30473,20789,68.2
48211,2926,2926,2024,69.2,2019,69.0,1917,65.5,102,3.5,5,0.2,902,30.8,2019,2019,(X),5.1,1475,1475,855,58.0,850,57.6,825,55.9,278,278,138,49.6,929,929,619,66.6
48213,65173,65173,33304,51.1,33280,51.1,31583,48.5,1697,2.6,24,0.0,31869,48.9,33280,33280,(X),5.1,33808,33808,15488,45.8,15488,45.8,14768,43.7,5269,5269,2576,48.9,10903,10903,6920,63.5
48215,597554,597554,347611,58.2,347471,58.1,321626,53.8,25845,4.3,140,0.0,249943,41.8,347471,347471,(X),7.4,310137,310137,158404,51.1,158377,51.1,147220,47.5,91921,91921,48757,53.0,179141,179141,102970,57.5
48217,28090,28090,16124,57.4,16124,57.4,14899,53.0,1225,4.4,0,0.0,11966,42.6,16124,16124,(X),7.6,14336,14336,7323,51.1,7323,51.1,6810,47.5,2508,2508,1680,67.0,5362,5362,3749,69.9
48219,17708,17708,11161,63.0,11156,63.0,10373,58.6,783,4.4,5,0.0,6547,37.0,11156,11156,(X),7.0,9096,9096,5042,55.4,5037,55.4,4716,51.8,1610,1610,944,58.6,3953,3953,2896,73.3
48221,46172,46172,24701,53.5,24655,53.4,23937,51.8,718,1.6,46,0.1,21471,46.5,24655,24655,(X),2.9,23642,23642,11046,46.7,11046,46.7,10623,44.9,3569,3569,2066,57.9,7556,7556,4610,61.0
48223,28157,28157,16701,59.3,16692,59.3,15927,56.6,765,2.7,9,0.0,11456,40.7,16692,16692,(X),4.6,14464,14464,7498,51.8,7498,51.8,7209,49.8,2603,2603,1545,59.4,5711,5711,3776,66.1
48225,18955,18955,8405,44.3,8378,44.2,8197,43.2,181,1.0,27,0.1,10550,55.7,8378,8378,(X),2.2,8496,8496,3891,45.8,3891,45.8,3814,44.9,1389,1389,858,61.8,2655,2655,1684,63.4
48227,29527,29527,15665,53.1,15629,52.9,14563,49.3,1066,3.6,36,0.1,13862,46.9,15629,15629,(X),6.8,12483,12483,7001,56.1,6987,56.0,6466,51.8,2509,2509,1706,68.0,5117,5117,3632,71.0
48229,3188,3188,1220,38.3,1220,38.3,1119,35.1,101,3.2,0,0.0,1968,61.7,1220,1220,(X),8.3,1555,1555,572,36.8,572,36.8,515,33.1,217,217,111,51.2,575,575,462,80.3
48231,72429,72429,42410,58.6,42404,58.5,40070,55.3,2334,3.2,6,0.0,30019,41.4,42404,42404,(X),5.5,37101,37101,19081,51.4,19081,51.4,18126,48.9,6689,6689,3793,56.7,14176,14176,9399,66.3
48233,16719,16719,9568,57.2,9568,57.2,8995,53.8,573,3.4,0,0.0,7151,42.8,9568,9568,(X),6.0,8424,8424,4139,49.1,4139,49.1,3876,46.0,1724,1724,980,56.8,3660,3660,2586,70.7
48235,1198,1198,703,58.7,687,57.3,642,53.6,45,3.8,16,1.3,495,41.3,687,687,(X),6.6,539,539,237,44.0,221,41.0,203,37.7,75,75,37,49.3,281,281,154,54.8
48237,7209,7209,3359,46.6,3359,46.6,3251,45.1,108,1.5,0,0.0,3850,53.4,3359,3359,(X),3.2,3060,3060,1231,40.2,1231,40.2,1198,39.2,540,540,180,33.3,1183,1183,644,54.4
48239,11401,11401,6860,60.2,6860,60.2,6580,57.7,280,2.5,0,0.0,4541,39.8,6860,6860,(X),4.1,5781,5781,2891,50.0,2891,50.0,2750,47.6,1208,1208,783,64.8,2421,2421,1974,81.5
48241,27955,27955,14335,51.3,14335,51.3,13109,46.9,1226,4.4,0,0.0,13620,48.7,14335,14335,(X),8.6,14320,14320,6733,47.0,6733,47.0,6045,42.2,2341,2341,1305,55.7,5436,5436,3027,55.7
48243,1884,1884,928,49.3,928,49.3,879,46.7,49,2.6,0,0.0,956,50.7,928,928,(X),5.3,948,948,452,47.7,452,47.7,436,46.0,89,89,78,87.6,278,278,276,99.3
48245,200900,200900,112509,56.0,112354,55.9,105903,52.7,6451,3.2,155,0.1,88391,44.0,112354,112354,(X),5.7,97816,97816,50889,52.0,50885,52.0,48149,49.2,19940,19940,10730,53.8,37558,37558,23643,63.0
48247,3809,3809,1988,52.2,1988,52.2,1759,46.2,229,6.0,0,0.0,1821,47.8,1988,1988,(X),11.5,2098,2098,885,42.2,885,42.2,814,38.8,473,473,145,30.7,945,945,482,51.0
48249,30794,30794,17082,55.5,17082,55.5,16190,52.6,892,2.9,0,0.0,13712,44.5,17082,17082,(X),5.2,16017,16017,7628,47.6,7628,47.6,7273,45.4,3686,3686,1696,46.0,7254,7254,4321,59.6
48251,125785,125785,78366,62.3,78205,62.2,74845,59.5,3360,2.7,161,0.1,47419,37.7,78205,78205,(X),4.3,63854,63854,35509,55.6,35509,55.6,33826,53.0,12566,12566,7597,60.5,27726,27726,18733,67.6
48253,16832,16832,5094,30.3,5076,30.2,4877,29.0,199,1.2,18,0.1,11738,69.7,5076,5076,(X),3.9,5870,5870,3004,51.2,3000,51.1,2894,49.3,952,952,421,44.2,2128,2128,1416,66.5
48255,12467,12467,5625,45.1,5625,45.1,5382,43.2,243,1.9,0,0.0,6842,54.9,5625,5625,(X),4.3,4883,4883,2341,47.9,2341,47.9,2193,44.9,915,915,584,63.8,2006,2006,1560,77.8
48257,89377,89377,59143,66.2,59090,66.1,55103,61.7,3987,4.5,53,0.1,30234,33.8,59090,59090,(X),6.7,45855,45855,27326,59.6,27326,59.6,25545,55.7,9763,9763,6366,65.2,21576,21576,15170,70.3
48259,33304,33304,20394,61.2,20377,61.2,19498,58.5,879,2.6,17,0.1,12910,38.8,20377,20377,(X),4.3,17199,17199,9195,53.5,9195,53.5,8920,51.9,2520,2520,1585,62.9,7069,7069,4760,67.3
48261,428,428,220,51.4,220,51.4,220,51.4,0,0.0,0,0.0,208,48.6,220,220,(X),0.0,238,238,91,38.2,91,38.2,91,38.2,89,89,23,25.8,78,78,57,73.1
48263,607,607,321,52.9,321,52.9,309,50.9,12,2.0,0,0.0,286,47.1,321,321,(X),3.7,348,348,163,46.8,163,46.8,159,45.7,60,60,41,68.3,78,78,78,100.0
48265,42550,42550,23116,54.3,23104,54.3,21870,51.4,1234,2.9,12,0.0,19434,45.7,23104,23104,(X),5.3,22304,22304,11348,50.9,11348,50.9,10709,48.0,3130,3130,1981,63.3,6148,6148,4546,73.9
48267,3649,3649,2192,60.1,2192,60.1,2124,58.2,68,1.9,0,0.0,1457,39.9,2192,2192,(X),3.1,1927,1927,1132,58.7,1132,58.7,1084,56.3,288,288,181,62.8,533,533,462,86.7
48269,171,171,132,77.2,132,77.2,122,71.3,10,5.8,0,0.0,39,22.8,132,132,(X),7.6,76,76,47,61.8,47,61.8,47,61.8,8,8,0,0.0,44,44,40,90.9
48271,3044,3044,1318,43.3,1300,42.7,1213,39.8,87,2.9,18,0.6,1726,56.7,1300,1300,(X),6.7,1166,1166,424,36.4,424,36.4,424,36.4,128,128,65,50.8,507,507,344,67.9
48273,24738,24738,15024,60.7,14536,58.8,13211,53.4,1325,5.4,488,2.0,9714,39.3,14536,14536,(X),9.1,12190,12190,6734,55.2,6703,55.0,6029,49.5,2537,2537,1485,58.5,4750,4750,3231,68.0
48275,2838,2838,1538,54.2,1538,54.2,1454,51.2,84,3.0,0,0.0,1300,45.8,1538,1538,(X),5.5,1436,1436,650,45.3,650,45.3,630,43.9,296,296,146,49.3,693,693,505,72.9
48277,39051,39051,22510,57.6,22481,57.6,21218,54.3,1263,3.2,29,0.1,16541,42.4,22481,22481,(X),5.6,20577,20577,10812,52.5,10812,52.5,10331,50.2,3719,3719,2241,60.3,7250,7250,5141,70.9
48279,9925,9925,5818,58.6,5818,58.6,5647,56.9,171,1.7,0,0.0,4107,41.4,5818,5818,(X),2.9,4924,4924,2464,50.0,2464,50.0,2389,48.5,1065,1065,573,53.8,2358,2358,1694,71.8
48281,16560,16560,9649,58.3,9455,57.1,8776,53.0,679,4.1,194,1.2,6911,41.7,9455,9455,(X),7.2,8357,8357,4370,52.3,4346,52.0,3958,47.4,1299,1299,824,63.4,3271,3271,2493,76.2
48283,6048,6048,2947,48.7,2947,48.7,2822,46.7,125,2.1,0,0.0,3101,51.3,2947,2947,(X),4.2,2362,2362,1148,48.6,1148,48.6,1125,47.6,524,524,241,46.0,989,989,671,67.8
48285,15726,15726,9273,59.0,9273,59.0,8969,57.0,304,1.9,0,0.0,6453,41.0,9273,9273,(X),3.3,8133,8133,4259,52.4,4259,52.4,4136,50.9,1455,1455,1051,72.2,3120,3120,2472,79.2
48287,13712,13712,8253,60.2,8253,60.2,8019,58.5,234,1.7,0,0.0,5459,39.8,8253,8253,(X),2.8,6805,6805,3731,54.8,3731,54.8,3650,53.6,1032,1032,667,64.6,2494,2494,1957,78.5
48289,13674,13674,6935,50.7,6935,50.7,6463,47.3,472,3.5,0,0.0,6739,49.3,6935,6935,(X),6.8,6778,6778,3112,45.9,3112,45.9,2882,42.5,1317,1317,822,62.4,2281,2281,1588,69.6
48291,63236,63236,32245,51.0,32245,51.0,30006,47.5,2239,3.5,0,0.0,30991,49.0,32245,32245,(X),6.9,32390,32390,12814,39.6,12814,39.6,11958,36.9,6889,6889,3493,50.7,12788,12788,6556,51.3
48293,18724,18724,9784,52.3,9784,52.3,8902,47.5,882,4.7,0,0.0,8940,47.7,9784,9784,(X),9.0,8964,8964,4121,46.0,4121,46.0,3934,43.9,1721,1721,897,52.1,3309,3309,1792,54.2
48295,2654,2654,1736,65.4,1736,65.4,1630,61.4,106,4.0,0,0.0,918,34.6,1736,1736,(X),6.1,1291,1291,678,52.5,678,52.5,630,48.8,331,331,185,55.9,529,529,370,69.9
48297,9896,9896,4539,45.9,4539,45.9,4437,44.8,102,1.0,0,0.0,5357,54.1,4539,4539,(X),2.2,4477,4477,1995,44.6,1995,44.6,1970,44.0,702,702,450,64.1,1652,1652,981,59.4
48299,18007,18007,8400,46.6,8381,46.5,7748,43.0,633,3.5,19,0.1,9607,53.4,8381,8381,(X),7.6,9211,9211,3875,42.1,3875,42.1,3680,40.0,893,893,619,69.3,1857,1857,1544,83.1
48301,78,78,36,46.2,36,46.2,36,46.2,0,0.0,0,0.0,42,53.8,36,36,(X),0.0,31,31,12,38.7,12,38.7,12,38.7,24,24,0,0.0,0,0,0,-
48303,236294,236294,154323,65.3,154094,65.2,147651,62.5,6443,2.7,229,0.1,81971,34.7,154094,154094,(X),4.2,120496,120496,73324,60.9,73299,60.8,70154,58.2,23323,23323,16016,68.7,44251,44251,33092,74.8
48305,4431,4431,2559,57.8,2557,57.7,2342,52.9,215,4.9,2,0.0,1872,42.2,2557,2557,(X),8.4,2148,2148,967,45.0,965,44.9,919,42.8,436,436,215,49.3,964,964,581,60.3
48307,6515,6515,3878,59.5,3878,59.5,3781,58.0,97,1.5,0,0.0,2637,40.5,3878,3878,(X),2.5,3286,3286,1726,52.5,1726,52.5,1710,52.0,513,513,431,84.0,1043,1043,869,83.3
48309,193661,193661,118759,61.3,118563,61.2,113281,58.5,5282,2.7,196,0.1,74902,38.7,118563,118563,(X),4.5,100442,100442,57589,57.3,57565,57.3,54586,54.3,20295,20295,13398,66.0,38121,38121,27444,72.0
48311,507,507,280,55.2,280,55.2,230,45.4,50,9.9,0,0.0,227,44.8,280,280,(X),17.9,211,211,97,46.0,97,46.0,92,43.6,41,41,17,41.5,123,123,104,84.6
48313,11384,11384,4542,39.9,4542,39.9,4402,38.7,140,1.2,0,0.0,6842,60.1,4542,4542,(X),3.1,4653,4653,2616,56.2,2616,56.2,2526,54.3,773,773,511,66.1,1956,1956,1470,75.2
48315,8449,8449,4078,48.3,4061,48.1,3612,42.8,449,5.3,17,0.2,4371,51.7,4061,4061,(X),11.1,4340,4340,1887,43.5,1887,43.5,1720,39.6,550,550,281,51.1,1136,1136,445,39.2
48317,4028,4028,2595,64.4,2595,64.4,2527,62.7,68,1.7,0,0.0,1433,35.6,2595,2595,(X),2.6,1941,1941,1032,53.2,1032,53.2,1025,52.8,566,566,240,42.4,1166,1166,835,71.6
48319,3507,3507,2242,63.9,2242,63.9,2115,60.3,127,3.6,0,0.0,1265,36.1,2242,2242,(X),5.7,1793,1793,964,53.8,964,53.8,926,51.6,268,268,236,88.1,602,602,461,76.6
48321,28441,28441,16914,59.5,16890,59.4,15709,55.2,1181,4.2,24,0.1,11527,40.5,16890,16890,(X),7.0,14317,14317,7331,51.2,7331,51.2,6925,48.4,2903,2903,1844,63.5,6030,6030,3617,60.0
48323,41773,41773,24337,58.3,24337,58.3,21520,51.5,2817,6.7,0,0.0,17436,41.7,24337,24337,(X),11.6,21158,21158,10886,51.5,10886,51.5,9361,44.2,6187,6187,3536,57.2,11468,11468,7417,64.7
48325,39111,39111,22190,56.7,22158,56.7,21359,54.6,799,2.0,32,0.1,16921,43.3,22158,22158,(X),3.6,18780,18780,10238,54.5,10238,54.5,9932,52.9,3451,3451,2155,62.4,7526,7526,5988,79.6
48327,1830,1830,1164,63.6,1164,63.6,1128,61.6,36,2.0,0,0.0,666,36.4,1164,1164,(X),3.1,876,876,504,57.5,504,57.5,490,55.9,41,41,41,100.0,255,255,185,72.5
48329,121945,121945,85794,70.4,85702,70.3,82866,68.0,2836,2.3,92,0.1,36151,29.6,85702,85702,(X),3.3,60955,60955,36086,59.2,36042,59.1,34711,56.9,16070,16070,8942,55.6,27954,27954,17932,64.1
48331,19273,19273,10367,53.8,10363,53.8,9931,51.5,432,2.2,4,0.0,8906,46.2,10363,10363,(X),4.2,9760,9760,4788,49.1,4788,49.1,4532,46.4,1779,1779,1103,62.0,3995,3995,2736,68.5
48333,3925,3925,1945,49.6,1939,49.4,1903,48.5,36,0.9,6,0.2,1980,50.4,1939,1939,(X),1.9,2100,2100,971,46.2,971,46.2,949,45.2,185,185,127,68.6,726,726,630,86.8
48335,7184,7184,2911,40.5,2911,40.5,2743,38.2,168,2.3,0,0.0,4273,59.5,2911,2911,(X),5.8,2568,2568,1321,51.4,1321,51.4,1188,46.3,485,485,226,46.6,957,957,641,67.0
48337,15487,15487,8711,56.2,8707,56.2,8240,53.2,467,3.0,4,0.0,6776,43.8,8707,8707,(X),5.4,7983,7983,3807,47.7,3807,47.7,3597,45.1,1266,1266,640,50.6,2827,2827,1750,61.9
48339,423918,423918,274718,64.8,274389,64.7,262084,61.8,12305,2.9,329,0.1,149200,35.2,274389,274389,(X),4.5,215573,215573,119645,55.5,119636,55.5,113203,52.5,45108,45108,26127,57.9,97217,97217,60878,62.6
48341,15656,15656,10634,67.9,10612,67.8,10090,64.4,522,3.3,22,0.1,5022,32.1,10612,10612,(X),4.9,7538,7538,4387,58.2,4387,58.2,4108,54.5,2279,2279,1374,60.3,4254,4254,2906,68.3
48343,9872,9872,5614,56.9,5614,56.9,5135,52.0,479,4.9,0,0.0,4258,43.1,5614,5614,(X),8.5,5196,5196,2778,53.5,2778,53.5,2524,48.6,698,698,447,64.0,1903,1903,1386,72.8
48345,874,874,545,62.4,545,62.4,503,57.6,42,4.8,0,0.0,329,37.6,545,545,(X),7.7,409,409,209,51.1,209,51.1,181,44.3,79,79,66,83.5,220,220,180,81.8
48347,51646,51646,30535,59.1,30535,59.1,27948,54.1,2587,5.0,0,0.0,21111,40.9,30535,30535,(X),8.5,27223,27223,14705,54.0,14705,54.0,13429,49.3,5119,5119,3610,70.5,9244,9244,6423,69.5
48349,37381,37381,22753,60.9,22753,60.9,20941,56.0,1812,4.8,0,0.0,14628,39.1,22753,22753,(X),8.0,19280,19280,10439,54.1,10439,54.1,9517,49.4,3801,3801,2236,58.8,7989,7989,5156,64.5
48351,11699,11699,5428,46.4,5397,46.1,4965,42.4,432,3.7,31,0.3,6271,53.6,5397,5397,(X),8.0,5532,5532,2210,39.9,2210,39.9,2008,36.3,732,732,347,47.4,2046,2046,1420,69.4
48353,11526,11526,6565,57.0,6565,57.0,6092,52.9,473,4.1,0,0.0,4961,43.0,6565,6565,(X),7.2,5682,5682,2654,46.7,2654,46.7,2455,43.2,1297,1297,571,44.0,2283,2283,1545,67.7
48355,280990,280990,177352,63.1,175891,62.6,165496,58.9,10395,3.7,1461,0.5,103638,36.9,175891,175891,(X),5.9,143930,143930,80983,56.3,80766,56.1,75940,52.8,27339,27339,16224,59.3,56995,56995,39119,68.6
48357,7490,7490,4895,65.4,4895,65.4,4627,61.8,268,3.6,0,0.0,2595,34.6,4895,4895,(X),5.5,3748,3748,2040,54.4,2040,54.4,1898,50.6,995,995,434,43.6,2113,2113,963,45.6
48359,1455,1455,830,57.0,830,57.0,800,55.0,30,2.1,0,0.0,625,43.0,830,830,(X),3.6,682,682,373,54.7,373,54.7,362,53.1,96,96,74,77.1,155,155,101,65.2
48361,65504,65504,39243,59.9,39223,59.9,37083,56.6,2140,3.3,20,0.0,26261,40.1,39223,39223,(X),5.5,33622,33622,17654,52.5,17645,52.5,16627,49.5,6526,6526,4118,63.1,12593,12593,8591,68.2
48363,22368,22368,12889,57.6,12889,57.6,11903,53.2,986,4.4,0,0.0,9479,42.4,12889,12889,(X),7.6,11467,11467,6011,52.4,6011,52.4,5518,48.1,2039,2039,1277,62.6,3933,3933,2782,70.7
48365,18441,18441,10335,56.0,10318,56.0,9846,53.4,472,2.6,17,0.1,8106,44.0,10318,10318,(X),4.6,9453,9453,4809,50.9,4809,50.9,4578,48.4,1447,1447,932,64.4,3475,3475,2320,66.8
48367,101562,101562,63590,62.6,63428,62.5,60252,59.3,3176,3.1,162,0.2,37972,37.4,63428,63428,(X),5.0,51578,51578,28377,55.0,28347,55.0,26717,51.8,9475,9475,6007,63.4,21875,21875,15669,71.6
48369,7306,7306,4541,62.2,4537,62.1,4476,61.3,61,0.8,4,0.1,2765,37.8,4537,4537,(X),1.3,3515,3515,1673,47.6,1673,47.6,1632,46.4,857,857,460,53.7,1912,1912,881,46.1
48371,12308,12308,6335,51.5,6318,51.3,6096,49.5,222,1.8,17,0.1,5973,48.5,6318,6318,(X),3.5,5024,5024,2520,50.2,2520,50.2,2407,47.9,1213,1213,554,45.7,2522,2522,1259,49.9
48373,39215,39215,19944,50.9,19941,50.9,18582,47.4,1359,3.5,3,0.0,19271,49.1,19941,19941,(X),6.8,17844,17844,8931,50.1,8928,50.0,8483,47.5,2838,2838,1925,67.8,6181,6181,4399,71.2
48375,90811,90811,54812,60.4,54756,60.3,52637,58.0,2119,2.3,56,0.1,35999,39.6,54756,54756,(X),3.9,43968,43968,24822,56.5,24811,56.4,23740,54.0,11182,11182,6617,59.2,19789,19789,13102,66.2
48377,5396,5396,2814,52.1,2814,52.1,2532,46.9,282,5.2,0,0.0,2582,47.9,2814,2814,(X),10.0,2843,2843,1223,43.0,1223,43.0,1096,38.6,680,680,352,51.8,1116,1116,612,54.8
48379,9402,9402,4941,52.6,4941,52.6,4690,49.9,251,2.7,0,0.0,4461,47.4,4941,4941,(X),5.1,4708,4708,2145,45.6,2145,45.6,2071,44.0,722,722,439,60.8,1428,1428,974,68.2
48381,103825,103825,72770,70.1,72638,70.0,70272,67.7,2366,2.3,132,0.1,31055,29.9,72638,72638,(X),3.3,53383,53383,34525,64.7,34493,64.6,33081,62.0,10242,10242,6991,68.3,19982,19982,15742,78.8
48383,2731,2731,1762,64.5,1762,64.5,1685,61.7,77,2.8,0,0.0,969,35.5,1762,1762,(X),4.4,1318,1318,663,50.3,663,50.3,611,46.4,300,300,139,46.3,807,807,494,61.2
48385,2825,2825,1307,46.3,1307,46.3,1292,45.7,15,0.5,0,0.0,1518,53.7,1307,1307,(X),1.1,1646,1646,752,45.7,752,45.7,743,45.1,260,260,165,63.5,328,328,210,64.0
48387,10194,10194,5327,52.3,5327,52.3,4910,48.2,417,4.1,0,0.0,4867,47.7,5327,5327,(X),7.8,5253,5253,2583,49.2,2583,49.2,2387,45.4,604,604,399,66.1,1486,1486,1122,75.5
48389,12108,12108,6125,50.6,6125,50.6,5681,46.9,444,3.7,0,0.0,5983,49.4,6125,6125,(X),7.2,4964,4964,2681,54.0,2681,54.0,2525,50.9,1048,1048,392,37.4,1959,1959,1181,60.3
48391,5701,5701,3103,54.4,3103,54.4,2809,49.3,294,5.2,0,0.0,2598,45.6,3103,3103,(X),9.5,2918,2918,1290,44.2,1290,44.2,1152,39.5,557,557,295,53.0,1041,1041,776,74.5
48393,691,691,372,53.8,372,53.8,367,53.1,5,0.7,0,0.0,319,46.2,372,372,(X),1.3,388,388,179,46.1,179,46.1,179,46.1,49,49,37,75.5,169,169,138,81.7
48395,13226,13226,7910,59.8,7907,59.8,7401,56.0,506,3.8,3,0.0,5316,40.2,7907,7907,(X),6.4,6886,6886,3683,53.5,3683,53.5,3476,50.5,1054,1054,773,73.3,2836,2836,2085,73.5
48397,70900,70900,48331,68.2,48223,68.0,46149,65.1,2074,2.9,108,0.2,22569,31.8,48223,48223,(X),4.3,36316,36316,22009,60.6,21995,60.6,20820,57.3,6670,6670,4072,61.0,18214,18214,12874,70.7
48399,8129,8129,4476,55.1,4473,55.0,4354,53.6,119,1.5,3,0.0,3653,44.9,4473,4473,(X),2.7,4067,4067,1939,47.7,1936,47.6,1904,46.8,631,631,405,64.2,1538,1538,1204,78.3
48401,42619,42619,22242,52.2,22207,52.1,20822,48.9,1385,3.2,35,0.1,20377,47.8,22207,22207,(X),6.2,19755,19755,9851,49.9,9851,49.9,9324,47.2,3622,3622,2155,59.5,7467,7467,4655,62.3
48403,8805,8805,3379,38.4,3379,38.4,3135,35.6,244,2.8,0,0.0,5426,61.6,3379,3379,(X),7.2,4558,4558,1640,36.0,1640,36.0,1605,35.2,464,464,188,40.5,1295,1295,617,47.6
48405,6865,6865,2861,41.7,2861,41.7,2591,37.7,270,3.9,0,0.0,4004,58.3,2861,2861,(X),9.4,3546,3546,1360,38.4,1360,38.4,1315,37.1,431,431,140,32.5,1086,1086,621,57.2
48407,22125,22125,10825,48.9,10825,48.9,10060,45.5,765,3.5,0,0.0,11300,51.1,10825,10825,(X),7.1,11280,11280,4755,42.2,4755,42.2,4449,39.4,1900,1900,870,45.8,3646,3646,2510,68.8
48409,50886,50886,30618,60.2,30490,59.9,29024,57.0,1466,2.9,128,0.3,20268,39.8,30490,30490,(X),4.8,25566,25566,13292,52.0,13272,51.9,12784,50.0,5667,5667,3025,53.4,11519,11519,7818,67.9
48411,4907,4907,2537,51.7,2530,51.6,2452,50.0,78,1.6,7,0.1,2370,48.3,2530,2530,(X),3.1,2358,2358,787,33.4,787,33.4,753,31.9,336,336,244,72.6,729,729,416,57.1
48413,2270,2270,1547,68.1,1547,68.1,1405,61.9,142,6.3,0,0.0,723,31.9,1547,1547,(X),9.2,1144,1144,690,60.3,690,60.3,627,54.8,212,212,128,60.4,604,604,438,72.5
48415,13258,13258,7032,53.0,7032,53.0,6740,50.8,292,2.2,0,0.0,6226,47.0,7032,7032,(X),4.2,5886,5886,2851,48.4,2851,48.4,2737,46.5,1440,1440,689,47.8,2629,2629,1966,74.8
48417,2617,2617,1645,62.9,1645,62.9,1512,57.8,133,5.1,0,0.0,972,37.1,1645,1645,(X),8.1,1353,1353,788,58.2,788,58.2,680,50.3,279,279,214,76.7,444,444,353,79.5
48419,19386,19386,10260,52.9,10260,52.9,9522,49.1,738,3.8,0,0.0,9126,47.1,10260,10260,(X),7.2,9831,9831,4502,45.8,4502,45.8,4022,40.9,2050,2050,1160,56.6,4442,4442,2374,53.4
48421,2442,2442,1643,67.3,1643,67.3,1629,66.7,14,0.6,0,0.0,799,32.7,1643,1643,(X),0.9,1176,1176,609,51.8,609,51.8,595,50.6,227,227,150,66.1,456,456,273,59.9
48423,175423,175423,106096,60.5,105905,60.4,99381,56.7,6524,3.7,191,0.1,69327,39.5,105905,105905,(X),6.2,92295,92295,50286,54.5,50271,54.5,47387,51.3,17984,17984,10389,57.8,34609,34609,23938,69.2
48425,6951,6951,3854,55.4,3854,55.4,3782,54.4,72,1.0,0,0.0,3097,44.6,3854,3854,(X),1.9,3581,3581,1745,48.7,1745,48.7,1706,47.6,621,621,483,77.8,1234,1234,930,75.4
48427,45201,45201,25494,56.4,25494,56.4,21842,48.3,3652,8.1,0,0.0,19707,43.6,25494,25494,(X),14.3,23407,23407,12252,52.3,12252,52.3,10553,45.1,7407,7407,3754,50.7,12885,12885,8703,67.5
48429,7488,7488,3915,52.3,3915,52.3,3647,48.7,268,3.6,0,0.0,3573,47.7,3915,3915,(X),6.8,3592,3592,1547,43.1,1547,43.1,1456,40.5,578,578,168,29.1,1293,1293,871,67.4
48431,892,892,596,66.8,596,66.8,587,65.8,9,1.0,0,0.0,296,33.2,596,596,(X),1.5,411,411,240,58.4,240,58.4,231,56.2,53,53,49,92.5,199,199,192,96.5
48433,1099,1099,601,54.7,600,54.6,586,53.3,14,1.3,1,0.1,498,45.3,600,600,(X),2.3,528,528,295,55.9,295,55.9,285,54.0,88,88,35,39.8,167,167,115,68.9
48435,3015,3015,2054,68.1,2054,68.1,1938,64.3,116,3.8,0,0.0,961,31.9,2054,2054,(X),5.6,1448,1448,786,54.3,786,54.3,740,51.1,348,348,189,54.3,583,583,508,87.1
48437,5854,5854,2843,48.6,2843,48.6,2657,45.4,186,3.2,0,0.0,3011,51.4,2843,2843,(X),6.5,2708,2708,1130,41.7,1130,41.7,1097,40.5,563,563,295,52.4,1257,1257,724,57.6
48439,1541466,1541466,1052013,68.2,1050005,68.1,997459,64.7,52546,3.4,2008,0.1,489453,31.8,1050005,1050005,(X),5.0,796957,796957,487850,61.2,487608,61.2,462560,58.0,169828,169828,105653,62.2,348464,348464,242477,69.6
48441,106124,106124,69577,65.6,65740,61.9,62890,59.3,2850,2.7,3837,3.6,36547,34.4,65740,65740,(X),4.3,54930,54930,32526,59.2,31961,58.2,30900,56.3,11838,11838,8184,69.1,19668,19668,14921,75.9
48443,761,761,380,49.9,380,49.9,344,45.2,36,4.7,0,0.0,381,50.1,380,380,(X),9.5,381,381,164,43.0,164,43.0,160,42.0,20,20,7,35.0,93,93,50,53.8
48445,9560,9560,5185,54.2,5185,54.2,4658,48.7,527,5.5,0,0.0,4375,45.8,5185,5185,(X),10.2,4573,4573,2381,52.1,2381,52.1,2126,46.5,1171,1171,572,48.8,2130,2130,1272,59.7
48447,1312,1312,743,56.6,743,56.6,703,53.6,40,3.0,0,0.0,569,43.4,743,743,(X),5.4,703,703,364,51.8,364,51.8,346,49.2,89,89,63,70.8,186,186,153,82.3
48449,24207,24207,15058,62.2,15025,62.1,14108,58.3,917,3.8,33,0.1,9149,37.8,15025,15025,(X),6.1,12409,12409,6749,54.4,6749,54.4,6226,50.2,2750,2750,1572,57.2,6029,6029,3879,64.3
48451,92376,92376,59098,64.0,56144,60.8,53898,58.3,2246,2.4,2954,3.2,33278,36.0,56144,56144,(X),4.0,46519,46519,26845,57.7,26146,56.2,24765,53.2,9050,9050,5709,63.1,17329,17329,13062,75.4
48453,961009,961009,694992,72.3,694369,72.3,666484,69.4,27885,2.9,623,0.1,266017,27.7,694369,694369,(X),4.0,477483,477483,312741,65.5,312555,65.5,299649,62.8,92447,92447,56746,61.4,166688,166688,112650,67.6
48455,11947,11947,5389,45.1,5389,45.1,4938,41.3,451,3.8,0,0.0,6558,54.9,5389,5389,(X),8.4,6292,6292,2445,38.9,2445,38.9,2255,35.8,851,851,600,70.5,1854,1854,1125,60.7
48457,17906,17906,7443,41.6,7443,41.6,6714,37.5,729,4.1,0,0.0,10463,58.4,7443,7443,(X),9.8,8079,8079,3352,41.5,3352,41.5,2949,36.5,1120,1120,582,52.0,2632,2632,1716,65.2
48459,32164,32164,18320,57.0,18320,57.0,16963,52.7,1357,4.2,0,0.0,13844,43.0,18320,18320,(X),7.4,16355,16355,7923,48.4,7923,48.4,7295,44.6,2974,2974,1774,59.7,6206,6206,3766,60.7
48461,2679,2679,1464,54.6,1464,54.6,1437,53.6,27,1.0,0,0.0,1215,45.4,1464,1464,(X),1.8,1273,1273,570,44.8,570,44.8,545,42.8,371,371,191,51.5,613,613,383,62.5
48463,20754,20754,12002,57.8,11985,57.7,11308,54.5,677,3.3,17,0.1,8752,42.2,11985,11985,(X),5.6,10709,10709,5409,50.5,5409,50.5,4999,46.7,2275,2275,1378,60.6,4456,4456,3043,68.3
48465,36510,36510,21581,59.1,20058,54.9,18916,51.8,1142,3.1,1523,4.2,14929,40.9,20058,20058,(X),5.7,17956,17956,9130,50.8,8867,49.4,8360,46.6,4516,4516,2576,57.0,8551,8551,6026,70.5
48467,43436,43436,23415,53.9,23393,53.9,22207,51.1,1186,2.7,22,0.1,20021,46.1,23393,23393,(X),5.1,22331,22331,10499,47.0,10490,47.0,9879,44.2,3605,3605,2040,56.6,7611,7611,4904,64.4
48469,71078,71078,45044,63.4,45032,63.4,42576,59.9,2456,3.5,12,0.0,26034,36.6,45032,45032,(X),5.5,36612,36612,21020,57.4,21020,57.4,19691,53.8,7246,7246,4674,64.5,14738,14738,10276,69.7
48471,61825,61825,25836,41.8,25811,41.7,24925,40.3,886,1.4,25,0.0,35989,58.2,25811,25811,(X),3.4,25164,25164,11979,47.6,11979,47.6,11467,45.6,4013,4013,2198,54.8,6317,6317,4003,63.4
48473,39130,39130,24202,61.9,24200,61.8,22715,58.1,1485,3.8,2,0.0,14928,38.1,24200,24200,(X),6.1,19899,19899,10572,53.1,10572,53.1,9876,49.6,3958,3958,2219,56.1,7552,7552,4842,64.1
48475,8740,8740,5242,60.0,5242,60.0,4914,56.2,328,3.8,0,0.0,3498,40.0,5242,5242,(X),6.3,4303,4303,2042,47.5,2042,47.5,1919,44.6,887,887,320,36.1,2116,2116,1125,53.2
48477,28150,28150,15829,56.2,15829,56.2,14874,52.8,955,3.4,0,0.0,12321,43.8,15829,15829,(X),6.0,14502,14502,7560,52.1,7560,52.1,7247,50.0,2452,2452,1462,59.6,4763,4763,3705,77.8
48479,190483,190483,112605,59.1,112530,59.1,106666,56.0,5864,3.1,75,0.0,77878,40.9,112530,112530,(X),5.2,99024,99024,50704,51.2,50704,51.2,47925,48.4,30063,30063,14315,47.6,56976,56976,32537,57.1
48481,31931,31931,19849,62.2,19849,62.2,18808,58.9,1041,3.3,0,0.0,12082,37.8,19849,19849,(X),5.2,16423,16423,8849,53.9,8849,53.9,8368,51.0,3205,3205,2069,64.6,7101,7101,5336,75.1
48483,4200,4200,2651,63.1,2648,63.0,2534,60.3,114,2.7,3,0.1,1549,36.9,2648,2648,(X),4.3,2106,2106,1116,53.0,1116,53.0,1074,51.0,423,423,238,56.3,898,898,612,68.2
48485,105242,105242,64395,61.2,58292,55.4,55188,52.4,3104,2.9,6103,5.8,40847,38.8,58292,58292,(X),5.3,50453,50453,28540,56.6,27879,55.3,26224,52.0,9825,9825,6191,63.0,18058,18058,12503,69.2
48487,10361,10361,6671,64.4,6655,64.2,6395,61.7,260,2.5,16,0.2,3690,35.6,6655,6655,(X),3.9,5257,5257,3150,59.9,3134,59.6,3030,57.6,727,727,674,92.7,1838,1838,1424,77.5
48489,16939,16939,8251,48.7,8251,48.7,6975,41.2,1276,7.5,0,0.0,8688,51.3,8251,8251,(X),15.5,7732,7732,3556,46.0,3556,46.0,3101,40.1,1514,1514,949,62.7,3329,3329,2173,65.3
48491,403616,403616,279485,69.2,278826,69.1,266094,65.9,12732,3.2,659,0.2,124131,30.8,278826,278826,(X),4.6,207643,207643,129796,62.5,129680,62.5,124156,59.8,41286,41286,26150,63.3,93138,93138,67625,72.6
48493,37907,37907,22787,60.1,22661,59.8,21274,56.1,1387,3.7,126,0.3,15120,39.9,22661,22661,(X),6.1,19012,19012,9922,52.2,9836,51.7,9380,49.3,3172,3172,2021,63.7,8089,8089,5527,68.3
48495,5767,5767,3421,59.3,3421,59.3,3273,56.8,148,2.6,0,0.0,2346,40.7,3421,3421,(X),4.3,2861,2861,1244,43.5,1244,43.5,1216,42.5,825,825,352,42.7,1428,1428,810,56.7
48497,50484,50484,30669,60.7,30663,60.7,29107,57.7,1556,3.1,6,0.0,19815,39.3,30663,30663,(X),5.1,25263,25263,13425,53.1,13425,53.1,12536,49.6,4957,4957,3043,61.4,10329,10329,7087,68.6
48499,36277,36277,16929,46.7,16929,46.7,15878,43.8,1051,2.9,0,0.0,19348,53.3,16929,16929,(X),6.2,18360,18360,7925,43.2,7925,43.2,7543,41.1,2334,2334,1169,50.1,5612,5612,3534,63.0
48501,5975,5975,4004,67.0,4004,67.0,3762,63.0,242,4.1,0,0.0,1971,33.0,4004,4004,(X),6.0,2993,2993,1535,51.3,1535,51.3,1391,46.5,961,961,474,49.3,1824,1824,1047,57.4
48503,14211,14211,8315,58.5,8300,58.4,8045,56.6,255,1.8,15,0.1,5896,41.5,8300,8300,(X),3.1,7304,7304,3461,47.4,3461,47.4,3335,45.7,1290,1290,868,67.3,2684,2684,1696,63.2
48505,10012,10012,5657,56.5,5657,56.5,5036,50.3,621,6.2,0,0.0,4355,43.5,5657,5657,(X),11.0,5110,5110,2427,47.5,2427,47.5,2086,40.8,1575,1575,893,56.7,3042,3042,1634,53.7
48507,9010,9010,5013,55.6,5013,55.6,4592,51.0,421,4.7,0,0.0,3997,44.4,5013,5013,(X),8.4,4419,4419,2330,52.7,2330,52.7,2216,50.1,1014,1014,511,50.4,2184,2184,1437,65.8
49001,4592,4592,2845,62.0,2845,62.0,2726,59.4,119,2.6,0,0.0,1747,38.0,2845,2845,(X),4.2,2227,2227,1144,51.4,1144,51.4,1060,47.6,633,633,293,46.3,1390,1390,922,66.3
49003,37796,37796,24038,63.6,24030,63.6,23020,60.9,1010,2.7,8,0.0,13758,36.4,24030,24030,(X),4.2,18861,18861,10084,53.5,10084,53.5,9540,50.6,5654,5654,2791,49.4,11093,11093,6571,59.2
49005,88602,88602,60826,68.7,60738,68.6,59014,66.6,1724,1.9,88,0.1,27776,31.3,60738,60738,(X),2.8,44429,44429,27027,60.8,27027,60.8,26164,58.9,12804,12804,6287,49.1,23950,23950,14234,59.4
49007,15533,15533,9392,60.5,9387,60.4,8868,57.1,519,3.3,5,0.0,6141,39.5,9387,9387,(X),5.5,7892,7892,4253,53.9,4253,53.9,4072,51.6,1568,1568,902,57.5,3538,3538,2354,66.5
49009,495,495,260,52.5,260,52.5,257,51.9,3,0.6,0,0.0,235,47.5,260,260,(X),1.2,171,171,99,57.9,99,57.9,99,57.9,25,25,5,20.0,97,97,46,47.4
49011,240826,240826,166300,69.1,164488,68.3,159157,66.1,5331,2.2,1812,0.8,74526,30.9,164488,164488,(X),3.2,120730,120730,71884,59.5,71599,59.3,69268,57.4,35531,35531,17443,49.1,73922,73922,45113,61.0
49013,13976,13976,8690,62.2,8690,62.2,8117,58.1,573,4.1,0,0.0,5286,37.8,8690,8690,(X),6.6,6830,6830,3584,52.5,3584,52.5,3357,49.2,2320,2320,1072,46.2,4162,4162,2595,62.3
49015,7431,7431,4211,56.7,4211,56.7,4035,54.3,176,2.4,0,0.0,3220,43.3,4211,4211,(X),4.2,3674,3674,1935,52.7,1935,52.7,1884,51.3,852,852,421,49.4,2216,2216,1323,59.7
49017,3968,3968,2301,58.0,2301,58.0,2211,55.7,90,2.3,0,0.0,1667,42.0,2301,2301,(X),3.9,1921,1921,1030,53.6,1030,53.6,999,52.0,369,369,179,48.5,788,788,390,49.5
49019,7889,7889,5372,68.1,5372,68.1,5078,64.4,294,3.7,0,0.0,2517,31.9,5372,5372,(X),5.5,3891,3891,2493,64.1,2493,64.1,2375,61.0,625,625,452,72.3,1261,1261,976,77.4
49021,37089,37089,22661,61.1,22649,61.1,21504,58.0,1145,3.1,12,0.0,14428,38.9,22649,22649,(X),5.1,18722,18722,10201,54.5,10201,54.5,9861,52.7,4829,4829,2175,45.0,9093,9093,5125,56.4
49023,7622,7622,5000,65.6,5000,65.6,4843,63.5,157,2.1,0,0.0,2622,34.4,5000,5000,(X),3.1,3780,3780,2197,58.1,2197,58.1,2124,56.2,1198,1198,628,52.4,2526,2526,1838,72.8
49025,5887,5887,3363,57.1,3363,57.1,3265,55.5,98,1.7,0,0.0,2524,42.9,3363,3363,(X),2.9,2974,2974,1673,56.3,1673,56.3,1640,55.1,518,518,365,70.5,1185,1185,899,75.9
49027,9196,9196,5725,62.3,5723,62.2,5539,60.2,184,2.0,2,0.0,3471,37.7,5723,5723,(X),3.2,4466,4466,2413,54.0,2413,54.0,2301,51.5,1159,1159,528,45.6,2725,2725,1863,68.4
49029,7798,7798,4945,63.4,4945,63.4,4809,61.7,136,1.7,0,0.0,2853,36.6,4945,4945,(X),2.8,3921,3921,2078,53.0,2078,53.0,1979,50.5,1198,1198,604,50.4,2809,2809,1283,45.7
49031,1515,1515,634,41.8,634,41.8,612,40.4,22,1.5,0,0.0,881,58.2,634,634,(X),3.5,710,710,342,48.2,342,48.2,337,47.5,99,99,44,44.4,290,290,170,58.6
49033,1610,1610,766,47.6,766,47.6,766,47.6,0,0.0,0,0.0,844,52.4,766,766,(X),0.0,846,846,390,46.1,390,46.1,390,46.1,213,213,67,31.5,607,607,408,67.2
49035,841676,841676,600122,71.3,599324,71.2,576623,68.5,22701,2.7,798,0.1,241554,28.7,599324,599324,(X),3.8,422087,422087,270060,64.0,269942,64.0,260169,61.6,101892,101892,59049,58.0,197585,197585,132579,67.1
49037,10982,10982,5983,54.5,5983,54.5,5488,50.0,495,4.5,0,0.0,4999,45.5,5983,5983,(X),8.3,5554,5554,2850,51.3,2850,51.3,2620,47.2,1395,1395,734,52.6,3163,3163,2245,71.0
49039,22730,22730,12159,53.5,12118,53.3,11243,49.5,875,3.8,41,0.2,10571,46.5,12118,12118,(X),7.2,10727,10727,5655,52.7,5655,52.7,5167,48.2,2252,2252,1125,50.0,4902,4902,3127,63.8
49041,15465,15465,9365,60.6,9355,60.5,8838,57.1,517,3.3,10,0.1,6100,39.4,9355,9355,(X),5.5,7668,7668,4108,53.6,4108,53.6,3851,50.2,1693,1693,893,52.7,4420,4420,2850,64.5
49043,31408,31408,22681,72.2,22650,72.1,22237,70.8,413,1.3,31,0.1,8727,27.8,22650,22650,(X),1.8,15455,15455,10127,65.5,10127,65.5,9943,64.3,2449,2449,1639,66.9,7689,7689,5523,71.8
49045,45846,45846,31324,68.3,31239,68.1,29272,63.8,1967,4.3,85,0.2,14522,31.7,31239,31239,(X),6.3,22941,22941,13642,59.5,13624,59.4,12834,55.9,6355,6355,3068,48.3,14936,14936,9752,65.3
49047,25385,25385,16230,63.9,16207,63.8,15090,59.4,1117,4.4,23,0.1,9155,36.1,16207,16207,(X),6.9,12541,12541,7010,55.9,7010,55.9,6540,52.1,3969,3969,2196,55.3,7627,7627,4505,59.1
49049,408939,408939,280406,68.6,279962,68.5,269203,65.8,10759,2.6,444,0.1,128533,31.4,279962,279962,(X),3.8,204040,204040,118612,58.1,118605,58.1,113791,55.8,68034,68034,28000,41.2,128792,128792,65922,51.2
49051,21866,21866,15379,70.3,15363,70.3,15195,69.5,168,0.8,16,0.1,6487,29.7,15363,15363,(X),1.1,10772,10772,6914,64.2,6914,64.2,6846,63.6,2828,2828,1729,61.1,6738,6738,4587,68.1
49053,121955,121955,68091,55.8,68050,55.8,65077,53.4,2973,2.4,41,0.0,53864,44.2,68050,68050,(X),4.4,62451,62451,30675,49.1,30646,49.1,29194,46.7,13503,13503,6739,49.9,28678,28678,17363,60.5
49055,2113,2113,1262,59.7,1262,59.7,1248,59.1,14,0.7,0,0.0,851,40.3,1262,1262,(X),1.1,1012,1012,565,55.8,565,55.8,563,55.6,156,156,100,64.1,509,509,390,76.6
49057,184063,184063,124607,67.7,124083,67.4,118705,64.5,5378,2.9,524,0.3,59456,32.3,124083,124083,(X),4.3,91883,91883,55923,60.9,55853,60.8,53630,58.4,22852,22852,14417,63.1,46257,46257,32873,71.1
50001,31312,31312,20943,66.9,20930,66.8,20040,64.0,890,2.8,13,0.0,10369,33.1,20930,20930,(X),4.3,16032,16032,10110,63.1,10110,63.1,9809,61.2,1844,1844,1377,74.7,4373,4373,3617,82.7
50003,29847,29847,18315,61.4,18315,61.4,17534,58.7,781,2.6,0,0.0,11532,38.6,18315,18315,(X),4.3,15580,15580,9101,58.4,9101,58.4,8783,56.4,1941,1941,1674,86.2,4609,4609,3633,78.8
50005,25178,25178,15189,60.3,15188,60.3,14620,58.1,568,2.3,1,0.0,9989,39.7,15188,15188,(X),3.7,12731,12731,7386,58.0,7386,58.0,7218,56.7,1712,1712,1122,65.5,3876,3876,2888,74.5
50007,136335,136335,94800,69.5,94512,69.3,90996,66.7,3516,2.6,288,0.2,41535,30.5,94512,94512,(X),3.7,70246,70246,46196,65.8,46176,65.7,44529,63.4,9084,9084,6427,70.8,19107,19107,14677,76.8
50009,5231,5231,2897,55.4,2897,55.4,2767,52.9,130,2.5,0,0.0,2334,44.6,2897,2897,(X),4.5,2597,2597,1399,53.9,1399,53.9,1332,51.3,319,319,220,69.0,729,729,547,75.0
50011,39347,39347,27238,69.2,27140,69.0,25988,66.0,1152,2.9,98,0.2,12109,30.8,27140,27140,(X),4.2,20021,20021,13228,66.1,13223,66.0,12626,63.1,3365,3365,2598,77.2,7364,7364,6250,84.9
50013,5891,5891,3878,65.8,3874,65.8,3691,62.7,183,3.1,4,0.1,2013,34.2,3874,3874,(X),4.7,2949,2949,1909,64.7,1909,64.7,1842,62.5,344,344,222,64.5,789,789,616,78.1
50015,20700,20700,14187,68.5,14185,68.5,13602,65.7,583,2.8,2,0.0,6513,31.5,14185,14185,(X),4.1,10349,10349,6673,64.5,6673,64.5,6461,62.4,1571,1571,1049,66.8,3456,3456,2529,73.2
50017,24124,24124,16130,66.9,16130,66.9,15404,63.9,726,3.0,0,0.0,7994,33.1,16130,16130,(X),4.5,12304,12304,7675,62.4,7675,62.4,7374,59.9,1659,1659,1196,72.1,3438,3438,2743,79.8
50019,22269,22269,12797,57.5,12783,57.4,12213,54.8,570,2.6,14,0.1,9472,42.5,12783,12783,(X),4.5,11174,11174,6291,56.3,6291,56.3,6073,54.3,1519,1519,1105,72.7,3511,3511,2620,74.6
50021,50137,50137,31406,62.6,31367,62.6,30183,60.2,1184,2.4,39,0.1,18731,37.4,31367,31367,(X),3.8,25670,25670,15567,60.6,15567,60.6,15044,58.6,2987,2987,2146,71.8,7099,7099,5397,76.0
50023,48546,48546,32562,67.1,32498,66.9,31374,64.6,1124,2.3,64,0.1,15984,32.9,32498,32498,(X),3.5,24723,24723,16146,65.3,16140,65.3,15748,63.7,3147,3147,2312,73.5,7534,7534,5760,76.5
50025,36339,36339,23164,63.7,23164,63.7,21908,60.3,1256,3.5,0,0.0,13175,36.3,23164,23164,(X),5.4,18855,18855,11762,62.4,11762,62.4,11173,59.3,2250,2250,1604,71.3,4938,4938,3983,80.7
50027,46467,46467,29662,63.8,29637,63.8,28422,61.2,1215,2.6,25,0.1,16805,36.2,29637,29637,(X),4.1,24016,24016,14914,62.1,14914,62.1,14270,59.4,2985,2985,1781,59.7,6862,6862,5256,76.6
51001,26638,26638,14503,54.4,14422,54.1,13817,51.9,605,2.3,81,0.3,12135,45.6,14422,14422,(X),4.2,13960,13960,6749,48.3,6732,48.2,6423,46.0,1983,1983,1190,60.0,4264,4264,3139,73.6
51003,87026,87026,53848,61.9,53539,61.5,52003,59.8,1536,1.8,309,0.4,33178,38.1,53539,53539,(X),2.9,45996,45996,26791,58.2,26744,58.1,26038,56.6,6639,6639,4558,68.7,14348,14348,10520,73.3
51005,12824,12824,6421,50.1,6412,50.0,6054,47.2,358,2.8,9,0.1,6403,49.9,6412,6412,(X),5.6,6630,6630,2978,44.9,2978,44.9,2790,42.1,798,798,428,53.6,1853,1853,1037,56.0
51007,10402,10402,6419,61.7,6419,61.7,6241,60.0,178,1.7,0,0.0,3983,38.3,6419,6419,(X),2.8,5269,5269,2994,56.8,2994,56.8,2900,55.0,812,812,583,71.8,1869,1869,1239,66.3
51009,26359,26359,15461,58.7,15455,58.6,14513,55.1,942,3.6,6,0.0,10898,41.3,15455,15455,(X),6.1,13896,13896,7762,55.9,7762,55.9,7307,52.6,1915,1915,1366,71.3,3903,3903,3006,77.0
51011,12591,12591,7250,57.6,7238,57.5,6963,55.3,275,2.2,12,0.1,5341,42.4,7238,7238,(X),3.8,6526,6526,3568,54.7,3568,54.7,3453,52.9,981,981,719,73.3,2217,2217,1570,70.8
51013,194843,194843,153292,78.7,150026,77.0,145621,74.7,4405,2.3,3266,1.7,41551,21.3,150026,150026,(X),2.9,98094,98094,72036,73.4,71452,72.8,69543,70.9,15884,15884,11498,72.4,23950,23950,17530,73.2
51015,61981,61981,36653,59.1,36494,58.9,35166,56.7,1328,2.1,159,0.3,25328,40.9,36494,36494,(X),3.6,30545,30545,17199,56.3,17199,56.3,16500,54.0,3974,3974,2600,65.4,9646,9646,6905,71.6
51017,3751,3751,2293,61.1,2293,61.1,2092,55.8,201,5.4,0,0.0,1458,38.9,2293,2293,(X),8.8,1867,1867,1148,61.5,1148,61.5,1018,54.5,194,194,153,78.9,456,456,333,73.0
51019,64309,64309,38623,60.1,38617,60.0,37064,57.6,1553,2.4,6,0.0,25686,39.9,38617,38617,(X),4.0,32800,32800,17921,54.6,17921,54.6,17365,52.9,4291,4291,2887,67.3,10571,10571,8009,75.8
51021,5560,5560,2751,49.5,2751,49.5,2555,46.0,196,3.5,0,0.0,2809,50.5,2751,2751,(X),7.1,2509,2509,1285,51.2,1285,51.2,1207,48.1,324,324,235,72.5,682,682,563,82.6
51023,27518,27518,16506,60.0,16496,59.9,15847,57.6,649,2.4,10,0.0,11012,40.0,16496,16496,(X),3.9,14055,14055,7624,54.2,7624,54.2,7398,52.6,1553,1553,946,60.9,4663,4663,3333,71.5
51025,14188,14188,6916,48.7,6916,48.7,6422,45.3,494,3.5,0,0.0,7272,51.3,6916,6916,(X),7.1,6605,6605,3485,52.8,3485,52.8,3344,50.6,936,936,787,84.1,1685,1685,1243,73.8
51027,18606,18606,6946,37.3,6946,37.3,6383,34.3,563,3.0,0,0.0,11660,62.7,6946,6946,(X),8.1,9242,9242,3009,32.6,3009,32.6,2853,30.9,917,917,516,56.3,2523,2523,1249,49.5
51029,14167,14167,7177,50.7,7163,50.6,6671,47.1,492,3.5,14,0.1,6990,49.3,7163,7163,(X),6.9,6290,6290,3470,55.2,3456,54.9,3216,51.1,816,816,546,66.9,2034,2034,1565,76.9
51031,45515,45515,27981,61.5,27964,61.4,26938,59.2,1026,2.3,17,0.0,17534,38.5,27964,27964,(X),3.7,23667,23667,13319,56.3,13319,56.3,12858,54.3,3246,3246,2139,65.9,7109,7109,5100,71.7
51033,23925,23925,16242,67.9,14481,60.5,13695,57.2,786,3.3,1761,7.4,7683,32.1,14481,14481,(X),5.4,12062,12062,7699,63.8,7476,62.0,7239,60.0,2827,2827,2051,72.6,3840,3840,2980,77.6
51035,24690,24690,13441,54.4,13421,54.4,12952,52.5,469,1.9,20,0.1,11249,45.6,13421,13421,(X),3.5,12452,12452,5936,47.7,5936,47.7,5671,45.5,1639,1639,1080,65.9,3461,3461,2731,78.9
51036,6031,6031,3511,58.2,3491,57.9,3318,55.0,173,2.9,20,0.3,2520,41.8,3491,3491,(X),5.0,3094,3094,1674,54.1,1660,53.7,1613,52.1,281,281,219,77.9,706,706,522,73.9
51037,9838,9838,5340,54.3,5338,54.3,5031,51.1,307,3.1,2,0.0,4498,45.7,5338,5338,(X),5.8,5050,5050,2684,53.1,2684,53.1,2483,49.2,739,739,628,85.0,1675,1675,1117,66.7
51041,267979,267979,183465,68.5,182469,68.1,173467,64.7,9002,3.4,996,0.4,84514,31.5,182469,182469,(X),4.9,141143,141143,89902,63.7,89760,63.6,85230,60.4,24087,24087,17030,70.7,53764,53764,40360,75.1
51043,11814,11814,7463,63.2,7463,63.2,7182,60.8,281,2.4,0,0.0,4351,36.8,7463,7463,(X),3.8,5878,5878,3419,58.2,3419,58.2,3297,56.1,808,808,429,53.1,1926,1926,1487,77.2
51045,4302,4302,2239,52.0,2239,52.0,2207,51.3,32,0.7,0,0.0,2063,48.0,2239,2239,(X),1.4,2277,2277,1041,45.7,1041,45.7,1031,45.3,245,245,179,73.1,619,619,438,70.8
51047,39180,39180,25615,65.4,25527,65.2,24163,61.7,1364,3.5,88,0.2,13565,34.6,25527,25527,(X),5.3,19600,19600,12348,63.0,12348,63.0,11797,60.2,3548,3548,2546,71.8,8246,8246,6199,75.2
51049,8139,8139,5015,61.6,5005,61.5,4656,57.2,349,4.3,10,0.1,3124,38.4,5005,5005,(X),7.0,4222,4222,2409,57.1,2409,57.1,2248,53.2,587,587,344,58.6,1232,1232,731,59.3
51051,12373,12373,4717,38.1,4698,38.0,4433,35.8,265,2.1,19,0.2,7656,61.9,4698,4698,(X),5.6,6122,6122,2182,35.6,2182,35.6,2090,34.1,821,821,423,51.5,1878,1878,831,44.2
51053,23159,23159,14653,63.3,14619,63.1,13594,58.7,1025,4.4,34,0.1,8506,36.7,14619,14619,(X),7.0,11982,11982,7190,60.0,7190,60.0,6684,55.8,1753,1753,956,54.5,3608,3608,2630,72.9
51057,9027,9027,5532,61.3,5511,61.1,5231,57.9,280,3.1,21,0.2,3495,38.7,5511,5511,(X),5.1,4945,4945,2966,60.0,2966,60.0,2813,56.9,667,667,570,85.5,1418,1418,1219,86.0
51059,902918,902918,648649,71.8,638310,70.7,611628,67.7,26682,3.0,10339,1.1,254269,28.2,638310,638310,(X),4.2,459360,459360,299836,65.3,297898,64.9,285161,62.1,87105,87105,57849,66.4,176340,176340,126555,71.8
51061,54822,54822,36905,67.3,36820,67.2,35568,64.9,1252,2.3,85,0.2,17917,32.7,36820,36820,(X),3.4,27970,27970,17182,61.4,17164,61.4,16680,59.6,4700,4700,3165,67.3,11161,11161,7776,69.7
51063,12931,12931,7357,56.9,7340,56.8,7163,55.4,177,1.4,17,0.1,5574,43.1,7340,7340,(X),2.4,6497,6497,3366,51.8,3366,51.8,3337,51.4,685,685,519,75.8,2228,2228,1490,66.9
51065,21630,21630,12999,60.1,12924,59.8,12252,56.6,672,3.1,75,0.3,8631,39.9,12924,12924,(X),5.2,12007,12007,6591,54.9,6516,54.3,6250,52.1,1335,1335,1031,77.2,3618,3618,2845,78.6
51067,46758,46758,26515,56.7,26485,56.6,25156,53.8,1329,2.8,30,0.1,20243,43.3,26485,26485,(X),5.0,24066,24066,12614,52.4,12596,52.3,12002,49.9,3165,3165,2038,64.4,6827,6827,4527,66.3
51069,67840,67840,44641,65.8,44522,65.6,42883,63.2,1639,2.4,119,0.2,23199,34.2,44522,44522,(X),3.7,34419,34419,20996,61.0,20996,61.0,20392,59.2,6001,6001,3790,63.2,12865,12865,9708,75.5
51071,13698,13698,7751,56.6,7750,56.6,7392,54.0,358,2.6,1,0.0,5947,43.4,7750,7750,(X),4.6,6959,6959,3542,50.9,3542,50.9,3379,48.6,864,864,337,39.0,2125,2125,1546,72.8
51073,30749,30749,18501,60.2,18144,59.0,17623,57.3,521,1.7,357,1.2,12248,39.8,18144,18144,(X),2.9,15587,15587,8262,53.0,8234,52.8,8006,51.4,2248,2248,1441,64.1,4973,4973,3573,71.8
51075,18850,18850,11087,58.8,11073,58.7,10715,56.8,358,1.9,14,0.1,7763,41.2,11073,11073,(X),3.2,9680,9680,5287,54.6,5287,54.6,5169,53.4,1003,1003,606,60.4,2870,2870,1952,68.0
51077,13407,13407,6908,51.5,6904,51.5,6457,48.2,447,3.3,4,0.0,6499,48.5,6904,6904,(X),6.5,6576,6576,3322,50.5,3322,50.5,3177,48.3,781,781,530,67.9,1678,1678,1166,69.5
51079,15221,15221,10416,68.4,10342,67.9,9820,64.5,522,3.4,74,0.5,4805,31.6,10342,10342,(X),5.0,7875,7875,5167,65.6,5167,65.6,4879,62.0,1213,1213,839,69.2,3277,3277,2394,73.1
51081,9925,9925,4222,42.5,4222,42.5,3943,39.7,279,2.8,0,0.0,5703,57.5,4222,4222,(X),6.6,3507,3507,1977,56.4,1977,56.4,1869,53.3,563,563,502,89.2,1185,1185,978,82.5
51083,28516,28516,15373,53.9,15352,53.8,14700,51.6,652,2.3,21,0.1,13143,46.1,15352,15352,(X),4.2,15091,15091,7555,50.1,7555,50.1,7289,48.3,1837,1837,1187,64.6,4940,4940,3585,72.6
51085,84111,84111,56754,67.5,56681,67.4,54987,65.4,1694,2.0,73,0.1,27357,32.5,56681,56681,(X),3.0,43514,43514,27686,63.6,27666,63.6,26920,61.9,6193,6193,4246,68.6,16315,16315,12637,77.5
51087,259041,259041,180816,69.8,180541,69.7,171012,66.0,9529,3.7,275,0.1,78225,30.2,180541,180541,(X),5.3,139102,139102,90943,65.4,90865,65.3,86120,61.9,22927,22927,16801,73.3,49089,49089,38137,77.7
51089,42689,42689,21890,51.3,21890,51.3,20064,47.0,1826,4.3,0,0.0,20799,48.7,21890,21890,(X),8.3,22334,22334,10574,47.3,10574,47.3,9777,43.8,2957,2957,2095,70.8,6565,6565,4391,66.9
51091,1943,1943,898,46.2,898,46.2,893,46.0,5,0.3,0,0.0,1045,53.8,898,898,(X),0.6,975,975,426,43.7,426,43.7,426,43.7,89,89,56,62.9,150,150,75,50.0
51093,29672,29672,19149,64.5,18918,63.8,17425,58.7,1493,5.0,231,0.8,10523,35.5,18918,18918,(X),7.9,15365,15365,8966,58.4,8926,58.1,8246,53.7,2282,2282,1689,74.0,5009,5009,3579,71.5
51095,60977,60977,35514,58.2,34852,57.2,33444,54.8,1408,2.3,662,1.1,25463,41.8,34852,34852,(X),4.0,31924,31924,17063,53.4,16890,52.9,16095,50.4,4225,4225,2593,61.4,10377,10377,7820,75.4
51097,5878,5878,3275,55.7,3275,55.7,3081,52.4,194,3.3,0,0.0,2603,44.3,3275,3275,(X),5.9,2969,2969,1407,47.4,1407,47.4,1228,41.4,362,362,116,32.0,892,892,729,81.7
51099,20090,20090,13808,68.7,13399,66.7,12863,64.0,536,2.7,409,2.0,6282,31.3,13399,13399,(X),4.0,9998,9998,6117,61.2,6060,60.6,5805,58.1,1953,1953,1091,55.9,4363,4363,3331,76.3
51101,13130,13130,8545,65.1,8545,65.1,8292,63.2,253,1.9,0,0.0,4585,34.9,8545,8545,(X),3.0,6754,6754,4096,60.6,4096,60.6,4039,59.8,1200,1200,929,77.4,2478,2478,1792,72.3
51103,9399,9399,4492,47.8,4492,47.8,4338,46.2,154,1.6,0,0.0,4907,52.2,4492,4492,(X),3.4,5069,5069,2100,41.4,2100,41.4,2046,40.4,530,530,304,57.4,943,943,736,78.0
51105,20152,20152,8365,41.5,8335,41.4,7474,37.1,861,4.3,30,0.1,11787,58.5,8335,8335,(X),10.3,9630,9630,3903,40.5,3903,40.5,3580,37.2,1286,1286,892,69.4,2910,2910,1444,49.6
51107,286061,286061,216855,75.8,215393,75.3,207877,72.7,7516,2.6,1462,0.5,69206,24.2,215393,215393,(X),3.5,145549,145549,99864,68.6,99698,68.5,95975,65.9,33809,33809,22317,66.0,74270,74270,54544,73.4
51109,28813,28813,17577,61.0,17577,61.0,16475,57.2,1102,3.8,0,0.0,11236,39.0,17577,17577,(X),6.3,14633,14633,8085,55.3,8085,55.3,7605,52.0,2225,2225,1662,74.7,4504,4504,3037,67.4
51111,10138,10138,4690,46.3,4675,46.1,4470,44.1,205,2.0,15,0.1,5448,53.7,4675,4675,(X),4.4,4768,4768,2166,45.4,2166,45.4,2100,44.0,720,720,511,71.0,1370,1370,972,70.9
51113,10689,10689,6431,60.2,6431,60.2,6080,56.9,351,3.3,0,0.0,4258,39.8,6431,6431,(X),5.5,5558,5558,2993,53.9,2993,53.9,2799,50.4,704,704,361,51.3,1890,1890,1531,81.0
51115,7686,7686,3912,50.9,3874,50.4,3768,49.0,106,1.4,38,0.5,3774,49.1,3874,3874,(X),2.7,4069,4069,1716,42.2,1711,42.0,1644,40.4,299,299,138,46.2,1018,1018,657,64.5
51117,25745,25745,12885,50.0,12885,50.0,12329,47.9,556,2.2,0,0.0,12860,50.0,12885,12885,(X),4.3,13441,13441,6719,50.0,6719,50.0,6469,48.1,1506,1506,1132,75.2,3706,3706,2813,75.9
51119,9210,9210,4502,48.9,4502,48.9,4302,46.7,200,2.2,0,0.0,4708,51.1,4502,4502,(X),4.4,4717,4717,2159,45.8,2159,45.8,2066,43.8,513,513,276,53.8,1114,1114,737,66.2
51121,84509,84509,48693,57.6,48434,57.3,46179,54.6,2255,2.7,259,0.3,35816,42.4,48434,48434,(X),4.7,40630,40630,22531,55.5,22458,55.3,21278,52.4,4697,4697,3104,66.1,9835,9835,7291,74.1
51125,12351,12351,7283,59.0,7283,59.0,6997,56.7,286,2.3,0,0.0,5068,41.0,7283,7283,(X),3.9,6443,6443,3486,54.1,3486,54.1,3324,51.6,641,641,494,77.1,1704,1704,1269,74.5
51127,17152,17152,11063,64.5,11041,64.4,10544,61.5,497,2.9,22,0.1,6089,35.5,11041,11041,(X),4.5,8570,8570,5233,61.1,5233,61.1,4990,58.2,1416,1416,853,60.2,2770,2770,2335,84.3
51131,9813,9813,5076,51.7,5053,51.5,4897,49.9,156,1.6,23,0.2,4737,48.3,5053,5053,(X),3.1,5172,5172,2713,52.5,2713,52.5,2654,51.3,647,647,455,70.3,1504,1504,1240,82.4
51133,10593,10593,5107,48.2,5107,48.2,4780,45.1,327,3.1,0,0.0,5486,51.8,5107,5107,(X),6.4,5519,5519,2432,44.1,2432,44.1,2395,43.4,545,545,296,54.3,1155,1155,858,74.3
51135,12832,12832,5812,45.3,5812,45.3,5596,43.6,216,1.7,0,0.0,7020,54.7,5812,5812,(X),3.7,5794,5794,2712,46.8,2712,46.8,2584,44.6,891,891,473,53.1,1920,1920,1235,64.3
51137,28672,28672,17641,61.5,17603,61.4,16575,57.8,1028,3.6,38,0.1,11031,38.5,17603,17603,(X),5.8,14871,14871,7984,53.7,7984,53.7,7563,50.9,2382,2382,1529,64.2,4823,4823,3087,64.0
51139,19476,19476,11557,59.3,11539,59.2,10794,55.4,745,3.8,18,0.1,7919,40.7,11539,11539,(X),6.5,9992,9992,5514,55.2,5514,55.2,5063,50.7,1374,1374,1025,74.6,3162,3162,2258,71.4
51141,15166,15166,7722,50.9,7722,50.9,7283,48.0,439,2.9,0,0.0,7444,49.1,7722,7722,(X),5.7,7693,7693,3327,43.2,3327,43.2,3150,40.9,1031,1031,516,50.0,1947,1947,1085,55.7
51143,51197,51197,29415,57.5,29209,57.1,27404,53.5,1805,3.5,206,0.4,21782,42.5,29209,29209,(X),6.2,26118,26118,14166,54.2,14123,54.1,13259,50.8,3149,3149,2270,72.1,8097,8097,6003,74.1
51145,24180,24180,13614,56.3,13602,56.3,13269,54.9,333,1.4,12,0.0,10566,43.7,13602,13602,(X),2.4,11233,11233,6469,57.6,6469,57.6,6328,56.3,1371,1371,1049,76.5,3523,3523,2610,74.1
51147,19661,19661,9112,46.3,9112,46.3,8531,43.4,581,3.0,0,0.0,10549,53.7,9112,9112,(X),6.4,9867,9867,4567,46.3,4567,46.3,4290,43.5,1073,1073,665,62.0,2341,2341,1479,63.2
51149,30671,30671,17726,57.8,16291,53.1,15090,49.2,1201,3.9,1435,4.7,12945,42.2,16291,16291,(X),7.4,13639,13639,7988,58.6,7764,56.9,7376,54.1,2345,2345,1326,56.5,5497,5497,3812,69.3
51153,344952,344952,251848,73.0,246265,71.4,234698,68.0,11567,3.4,5583,1.6,93104,27.0,246265,246265,(X),4.7,174690,174690,116140,66.5,115350,66.0,109245,62.5,40781,40781,26101,64.0,80504,80504,59179,73.5
51155,28913,28913,16482,57.0,16444,56.9,15441,53.4,1003,3.5,38,0.1,12431,43.0,16444,16444,(X),6.1,14481,14481,7789,53.8,7759,53.6,7325,50.6,1728,1728,1243,71.9,4065,4065,3085,75.9
51157,6238,6238,3641,58.4,3641,58.4,3499,56.1,142,2.3,0,0.0,2597,41.6,3641,3641,(X),3.9,3123,3123,1681,53.8,1681,53.8,1598,51.2,333,333,237,71.2,895,895,702,78.4
51159,7473,7473,3559,47.6,3557,47.6,3489,46.7,68,0.9,2,0.0,3914,52.4,3557,3557,(X),1.9,3175,3175,1733,54.6,1733,54.6,1703,53.6,314,314,284,90.4,1127,1127,643,57.1
51161,77007,77007,47461,61.6,47435,61.6,45700,59.3,1735,2.3,26,0.0,29546,38.4,47435,47435,(X),3.7,40636,40636,22877,56.3,22877,56.3,22164,54.5,5092,5092,3717,73.0,12677,12677,8954,70.6
51163,19017,19017,10809,56.8,10788,56.7,10153,53.4,635,3.3,21,0.1,8208,43.2,10788,10788,(X),5.9,9596,9596,5082,53.0,5072,52.9,4769,49.7,1337,1337,799,59.8,2394,2394,1821,76.1
51165,63966,63966,40657,63.6,40641,63.5,39144,61.2,1497,2.3,16,0.0,23309,36.4,40641,40641,(X),3.7,33046,33046,19047,57.6,19039,57.6,18191,55.0,5035,5035,3528,70.1,11700,11700,8526,72.9
51167,22909,22909,10209,44.6,10205,44.5,9508,41.5,697,3.0,4,0.0,12700,55.4,10205,10205,(X),6.8,11767,11767,4715,40.1,4715,40.1,4554,38.7,1370,1370,797,58.2,3190,3190,1456,45.6
51169,18374,18374,8846,48.1,8831,48.1,8340,45.4,491,2.7,15,0.1,9528,51.9,8831,8831,(X),5.6,9141,9141,3847,42.1,3847,42.1,3661,40.1,1098,1098,844,76.9,2375,2375,1686,71.0
51171,34898,34898,21501,61.6,21460,61.5,20419,58.5,1041,3.0,41,0.1,13397,38.4,21460,21460,(X),4.9,18114,18114,10065,55.6,10065,55.6,9693,53.5,2641,2641,1881,71.2,6041,6041,4689,77.6
51173,25823,25823,13368,51.8,13368,51.8,12593,48.8,775,3.0,0,0.0,12455,48.2,13368,13368,(X),5.8,13287,13287,6248,47.0,6248,47.0,5848,44.0,1645,1645,1099,66.8,3791,3791,2371,62.5
51175,14906,14906,8180,54.9,8149,54.7,7799,52.3,350,2.3,31,0.2,6726,45.1,8149,8149,(X),4.3,7107,7107,3854,54.2,3849,54.2,3726,52.4,1000,1000,707,70.7,2195,2195,1661,75.7
51177,102321,102321,69486,67.9,69084,67.5,65438,64.0,3646,3.6,402,0.4,32835,32.1,69084,69084,(X),5.3,52555,52555,32160,61.2,32129,61.1,30724,58.5,9654,9654,6121,63.4,22018,22018,15938,72.4
51179,110583,110583,76994,69.6,73328,66.3,70371,63.6,2957,2.7,3666,3.3,33589,30.4,73328,73328,(X),4.0,55001,55001,34711,63.1,34445,62.6,32983,60.0,10678,10678,6550,61.3,25765,25765,17613,68.4
51181,5559,5559,3219,57.9,3213,57.8,2983,53.7,230,4.1,6,0.1,2340,42.1,3213,3213,(X),7.2,2876,2876,1614,56.1,1614,56.1,1485,51.6,348,348,226,64.9,754,754,556,73.7
51183,9958,9958,3670,36.9,3659,36.7,3339,33.5,320,3.2,11,0.1,6288,63.1,3659,3659,(X),8.7,3902,3902,2059,52.8,2054,52.6,1890,48.4,520,520,446,85.8,1102,1102,857,77.8
51185,34971,34971,16893,48.3,16883,48.3,15604,44.6,1279,3.7,10,0.0,18078,51.7,16883,16883,(X),7.6,17651,17651,7528,42.6,7528,42.6,6859,38.9,2439,2439,1300,53.3,4977,4977,2784,55.9
51187,31872,31872,20324,63.8,20311,63.7,19074,59.8,1237,3.9,13,0.0,11548,36.2,20311,20311,(X),6.1,15959,15959,9121,57.2,9121,57.2,8516,53.4,2829,2829,1710,60.4,5365,5365,3201,59.7
51191,45616,45616,25457,55.8,25403,55.7,23898,52.4,1505,3.3,54,0.1,20159,44.2,25403,25403,(X),5.9,23282,23282,12390,53.2,12375,53.2,11777,50.6,2593,2593,1964,75.7,6353,6353,4670,73.5
51193,14616,14616,8381,57.3,8241,56.4,7610,52.1,631,4.3,140,1.0,6235,42.7,8241,8241,(X),7.7,7643,7643,4122,53.9,4122,53.9,3728,48.8,1002,1002,491,49.0,2187,2187,1439,65.8
51195,32156,32156,14415,44.8,14402,44.8,13075,40.7,1327,4.1,13,0.0,17741,55.2,14402,14402,(X),9.2,15163,15163,6197,40.9,6192,40.8,5676,37.4,2221,2221,1189,53.5,4823,4823,2527,52.4
51197,23918,23918,13994,58.5,13994,58.5,13070,54.6,924,3.9,0,0.0,9924,41.5,13994,13994,(X),6.6,12272,12272,6644,54.1,6644,54.1,6201,50.5,1358,1358,923,68.0,4008,4008,2940,73.4
51199,53188,53188,35667,67.1,32228,60.6,30286,56.9,1942,3.7,3439,6.5,17521,32.9,32228,32228,(X),6.0,27146,27146,15850,58.4,15433,56.9,14523,53.5,4464,4464,2667,59.7,11308,11308,8174,72.3
51510,130057,130057,101862,78.3,99424,76.4,96180,74.0,3244,2.5,2438,1.9,28195,21.7,99424,99424,(X),3.3,68352,68352,50151,73.4,49624,72.6,47854,70.0,12760,12760,8349,65.4,14918,14918,11163,74.8
51520,13734,13734,7641,55.6,7624,55.5,7174,52.2,450,3.3,17,0.1,6093,44.4,7624,7624,(X),5.9,7281,7281,3832,52.6,3832,52.6,3666,50.4,1030,1030,677,65.7,2210,2210,1643,74.3
51530,5262,5262,3070,58.3,3065,58.2,2991,56.8,74,1.4,5,0.1,2192,41.7,3065,3065,(X),2.4,2894,2894,1568,54.2,1563,54.0,1520,52.5,336,336,222,66.1,741,741,575,77.6
51540,40493,40493,25826,63.8,25650,63.3,24605,60.8,1045,2.6,176,0.4,14667,36.2,25650,25650,(X),4.1,21016,21016,13522,64.3,13505,64.3,12898,61.4,2855,2855,2048,71.7,4107,4107,3044,74.1
51550,186848,186848,123312,66.0,116386,62.3,110464,59.1,5922,3.2,6926,3.7,63536,34.0,116386,116386,(X),5.1,96493,96493,59244,61.4,58074,60.2,55224,57.2,17611,17611,11649,66.1,37558,37558,26902,71.6
51570,13923,13923,8441,60.6,8391,60.3,7624,54.8,767,5.5,50,0.4,5482,39.4,8391,8391,(X),9.1,7680,7680,4080,53.1,4077,53.1,3764,49.0,1282,1282,917,71.5,2514,2514,1768,70.3
51580,4601,4601,2608,56.7,2580,56.1,2454,53.3,126,2.7,28,0.6,1993,43.3,2580,2580,(X),4.9,2349,2349,1258,53.6,1258,53.6,1183,50.4,283,283,244,86.2,692,692,519,75.0
51590,33276,33276,18366,55.2,18326,55.1,16636,50.0,1690,5.1,40,0.1,14910,44.8,18326,18326,(X),9.2,18351,18351,9622,52.4,9622,52.4,8756,47.7,2910,2910,1949,67.0,5361,5361,3784,70.6
51595,4183,4183,2528,60.4,2528,60.4,1939,46.4,589,14.1,0,0.0,1655,39.6,2528,2528,(X),23.3,2277,2277,1247,54.8,1247,54.8,1009,44.3,299,299,259,86.6,1052,1052,826,78.5
51600,18995,18995,13318,70.1,13252,69.8,12717,66.9,535,2.8,66,0.3,5677,29.9,13252,13252,(X),4.0,9709,9709,6157,63.4,6143,63.3,5905,60.8,2226,2226,1675,75.2,2939,2939,2264,77.0
51610,10819,10819,8062,74.5,8028,74.2,7717,71.3,311,2.9,34,0.3,2757,25.5,8028,8028,(X),3.9,5661,5661,3891,68.7,3891,68.7,3702,65.4,1027,1027,697,67.9,2498,2498,1750,70.1
51620,6318,6318,4001,63.3,4001,63.3,3402,53.8,599,9.5,0,0.0,2317,36.7,4001,4001,(X),15.0,3625,3625,2191,60.4,2191,60.4,1880,51.9,483,483,425,88.0,1417,1417,1239,87.4
51630,23012,23012,16346,71.0,16201,70.4,15332,66.6,869,3.8,145,0.6,6666,29.0,16201,16201,(X),5.4,12782,12782,8251,64.6,8205,64.2,7713,60.3,2280,2280,1642,72.0,3420,3420,2612,76.4
51640,5383,5383,2980,55.4,2980,55.4,2788,51.8,192,3.6,0,0.0,2403,44.6,2980,2980,(X),6.4,2834,2834,1515,53.5,1515,53.5,1407,49.6,343,343,160,46.6,1002,1002,735,73.4
51650,109643,109643,71645,65.3,66810,60.9,61974,56.5,4836,4.4,4835,4.4,37998,34.7,66810,66810,(X),7.2,57429,57429,35312,61.5,34159,59.5,31871,55.5,9170,9170,6014,65.6,17761,17761,13486,75.9
51660,45482,45482,27189,59.8,27108,59.6,25898,56.9,1210,2.7,81,0.2,18293,40.2,27108,27108,(X),4.5,23895,23895,13436,56.2,13415,56.1,12634,52.9,3150,3150,2140,67.9,5187,5187,3926,75.7
51670,17302,17302,10368,59.9,10234,59.1,9384,54.2,850,4.9,134,0.8,6934,40.1,10234,10234,(X),8.3,9462,9462,5289,55.9,5289,55.9,4822,51.0,1777,1777,1042,58.6,3555,3555,2839,79.9
51678,6606,6606,2442,37.0,2350,35.6,2251,34.1,99,1.5,92,1.4,4164,63.0,2350,2350,(X),4.2,2804,2804,1247,44.5,1228,43.8,1147,40.9,195,195,55,28.2,371,371,316,85.2
51680,66433,66433,38660,58.2,38571,58.1,36191,54.5,2380,3.6,89,0.1,27773,41.8,38571,38571,(X),6.2,35927,35927,19414,54.0,19396,54.0,18185,50.6,5374,5374,3738,69.6,9233,9233,6892,74.6
51683,31506,31506,23492,74.6,23394,74.3,22051,70.0,1343,4.3,98,0.3,8014,25.4,23394,23394,(X),5.7,15792,15792,10594,67.1,10580,67.0,9992,63.3,3842,3842,2428,63.2,6687,6687,4632,69.3
51685,12640,12640,9250,73.2,9226,73.0,8645,68.4,581,4.6,24,0.2,3390,26.8,9226,9226,(X),6.3,6018,6018,4081,67.8,4081,67.8,3724,61.9,1257,1257,876,69.7,2679,2679,2117,79.0
51690,10183,10183,5796,56.9,5796,56.9,5345,52.5,451,4.4,0,0.0,4387,43.1,5796,5796,(X),7.8,5687,5687,3045,53.5,3045,53.5,2836,49.9,1152,1152,678,58.9,1709,1709,1135,66.4
51700,142166,142166,95838,67.4,87670,61.7,81765,57.5,5905,4.2,8168,5.7,46328,32.6,87670,87670,(X),6.7,74464,74464,46329,62.2,45018,60.5,41541,55.8,15380,15380,10158,66.0,24176,24176,17256,71.4
51710,201428,201428,139189,69.1,114289,56.7,104931,52.1,9358,4.6,24900,12.4,62239,30.9,114289,114289,(X),8.2,95544,95544,60640,63.5,55748,58.3,51002,53.4,18674,18674,12622,67.6,27065,27065,20051,74.1
51720,3112,3112,1786,57.4,1786,57.4,1539,49.5,247,7.9,0,0.0,1326,42.6,1786,1786,(X),13.8,1788,1788,1006,56.3,1006,56.3,889,49.7,328,328,252,76.8,595,595,484,81.3
51730,25609,25609,15542,60.7,15088,58.9,13387,52.3,1701,6.6,454,1.8,10067,39.3,15088,15088,(X),11.3,14145,14145,8457,59.8,8314,58.8,7622,53.9,2356,2356,1860,78.9,3829,3829,3011,78.6
51735,9880,9880,6222,63.0,6008,60.8,5690,57.6,318,3.2,214,2.2,3658,37.0,6008,6008,(X),5.3,5089,5089,2767,54.4,2698,53.0,2507,49.3,617,617,358,58.0,1990,1990,1453,73.0
51740,75069,75069,48896,65.1,45600,60.7,41388,55.1,4212,5.6,3296,4.4,26173,34.9,45600,45600,(X),9.2,39366,39366,23774,60.4,22914,58.2,20722,52.6,7883,7883,5299,67.2,12372,12372,9636,77.9
51750,16037,16037,8345,52.0,8315,51.8,7822,48.8,493,3.1,30,0.2,7692,48.0,8315,8315,(X),5.9,8454,8454,4491,53.1,4463,52.8,4200,49.7,522,522,259,49.6,1222,1222,789,64.6
51760,187419,187419,122582,65.4,121985,65.1,112654,60.1,9331,5.0,597,0.3,64837,34.6,121985,121985,(X),7.6,99548,99548,62965,63.3,62854,63.1,57941,58.2,15419,15419,11384,73.8,21420,21420,15786,73.7
51770,79627,79627,51028,64.1,50937,64.0,47450,59.6,3487,4.4,91,0.1,28599,35.9,50937,50937,(X),6.8,42148,42148,24860,59.0,24800,58.8,23063,54.7,7947,7947,5747,72.3,12145,12145,8873,73.1
51775,21168,21168,12935,61.1,12897,60.9,12228,57.8,669,3.2,38,0.2,8233,38.9,12897,12897,(X),5.2,11337,11337,6704,59.1,6680,58.9,6413,56.6,1527,1527,1081,70.8,2981,2981,2513,84.3
51790,20312,20312,12185,60.0,12170,59.9,11775,58.0,395,1.9,15,0.1,8127,40.0,12170,12170,(X),3.2,11331,11331,6086,53.7,6086,53.7,5912,52.2,1556,1556,911,58.5,2667,2667,2064,77.4
51800,69571,69571,46543,66.9,44729,64.3,41944,60.3,2785,4.0,1814,2.6,23028,33.1,44729,44729,(X),6.2,36377,36377,22493,61.8,22155,60.9,20917,57.5,6921,6921,4472,64.6,13920,13920,10576,76.0
51810,360313,360313,254098,70.5,231348,64.2,220127,61.1,11221,3.1,22750,6.3,106215,29.5,231348,231348,(X),4.9,185176,185176,118834,64.2,115197,62.2,110042,59.4,32965,32965,21262,64.5,64011,64011,46922,73.3
51820,17265,17265,10793,62.5,10776,62.4,10293,59.6,483,2.8,17,0.1,6472,37.5,10776,10776,(X),4.5,9167,9167,4965,54.2,4965,54.2,4833,52.7,1678,1678,1172,69.8,3000,3000,2105,70.2
51830,13418,13418,6603,49.2,6515,48.6,6027,44.9,488,3.6,88,0.7,6815,50.8,6515,6515,(X),7.5,7536,7536,3483,46.2,3483,46.2,3208,42.6,560,560,379,67.7,1038,1038,815,78.5
51840,22195,22195,14281,64.3,14253,64.2,13718,61.8,535,2.4,28,0.1,7914,35.7,14253,14253,(X),3.8,11564,11564,7000,60.5,7000,60.5,6692,57.9,1970,1970,1613,81.9,3997,3997,2919,73.0
53001,13323,13323,8420,63.2,8420,63.2,7890,59.2,530,4.0,0,0.0,4903,36.8,8420,8420,(X),6.3,6678,6678,3584,53.7,3584,53.7,3361,50.3,2203,2203,1498,68.0,4391,4391,2954,67.3
53003,18314,18314,10354,56.5,10354,56.5,9643,52.7,711,3.9,0,0.0,7960,43.5,10354,10354,(X),6.9,9453,9453,4993,52.8,4993,52.8,4611,48.8,1239,1239,935,75.5,3150,3150,2230,70.8
53005,147845,147845,91627,62.0,91475,61.9,86708,58.6,4767,3.2,152,0.1,56218,38.0,91475,91475,(X),5.2,74523,74523,41194,55.3,41194,55.3,39153,52.5,16279,16279,9702,59.6,33711,33711,21985,65.2
53007,59783,59783,36649,61.3,36619,61.3,34693,58.0,1926,3.2,30,0.1,23134,38.7,36619,36619,(X),5.3,30248,30248,16823,55.6,16805,55.6,15774,52.1,5393,5393,3817,70.8,11621,11621,8610,74.1
53009,63094,63094,31213,49.5,31029,49.2,28644,45.4,2385,3.8,184,0.3,31881,50.5,31029,31029,(X),7.7,31988,31988,14439,45.1,14417,45.1,13513,42.2,4035,4035,2268,56.2,7949,7949,5521,69.5
53011,364435,364435,234257,64.3,233844,64.2,221205,60.7,12639,3.5,413,0.1,130178,35.7,233844,233844,(X),5.4,186148,186148,106968,57.5,106846,57.4,101043,54.3,33934,33934,19050,56.1,75653,75653,50163,66.3
53013,3350,3350,1845,55.1,1845,55.1,1762,52.6,83,2.5,0,0.0,1505,44.9,1845,1845,(X),4.5,1721,1721,858,49.9,858,49.9,820,47.6,175,175,86,49.1,535,535,383,71.6
53015,83678,83678,47440,56.7,47402,56.6,43701,52.2,3701,4.4,38,0.0,36238,43.3,47402,47402,(X),7.8,42470,42470,22140,52.1,22140,52.1,20363,47.9,7118,7118,4475,62.9,15313,15313,11383,74.3
53017,31539,31539,19759,62.6,19749,62.6,18962,60.1,787,2.5,10,0.0,11780,37.4,19749,19749,(X),4.0,15808,15808,9077,57.4,9077,57.4,8754,55.4,3423,3423,2347,68.6,6830,6830,5066,74.2
53019,6435,6435,2869,44.6,2869,44.6,2648,41.1,221,3.4,0,0.0,3566,55.4,2869,2869,(X),7.7,3147,3147,1340,42.6,1340,42.6,1240,39.4,355,355,209,58.9,822,822,546,66.4
53021,63838,63838,42098,65.9,42097,65.9,39752,62.3,2345,3.7,1,0.0,21740,34.1,42097,42097,(X),5.6,30339,30339,18285,60.3,18285,60.3,17228,56.8,9533,9533,5913,62.0,19121,19121,13767,72.0
53023,1783,1783,997,55.9,997,55.9,923,51.8,74,4.2,0,0.0,786,44.1,997,997,(X),7.4,945,945,472,49.9,472,49.9,438,46.3,163,163,83,50.9,350,350,239,68.3
53025,69406,69406,43519,62.7,43427,62.6,40985,59.1,2442,3.5,92,0.1,25887,37.3,43427,43427,(X),5.6,34177,34177,18639,54.5,18548,54.3,17456,51.1,8875,8875,5140,57.9,18444,18444,12952,70.2
53027,58610,58610,29979,51.1,29888,51.0,27388,46.7,2500,4.3,91,0.2,28631,48.9,29888,29888,(X),8.4,28382,28382,14249,50.2,14249,50.2,13213,46.6,4512,4512,2906,64.4,9176,9176,6175,67.3
53029,68293,68293,39592,58.0,34356,50.3,32257,47.2,2099,3.1,5236,7.7,28701,42.0,34356,34356,(X),6.1,34312,34312,17496,51.0,16434,47.9,15550,45.3,5131,5131,2958,57.6,9398,9398,6334,67.4
53031,27428,27428,12435,45.3,12351,45.0,11569,42.2,782,2.9,84,0.3,14993,54.7,12351,12351,(X),6.3,13776,13776,6142,44.6,6128,44.5,5925,43.0,1188,1188,760,64.0,2350,2350,1609,68.5
53033,1765344,1765344,1233848,69.9,1231992,69.8,1176560,66.6,55432,3.1,1856,0.1,531496,30.1,1231992,1231992,(X),4.5,885498,885498,564918,63.8,564580,63.8,538590,60.8,151645,151645,92279,60.9,278422,278422,189955,68.2
53035,214355,214355,132489,61.8,119537,55.8,113310,52.9,6227,2.9,12952,6.0,81866,38.2,119537,119537,(X),5.2,104904,104904,57249,54.6,55989,53.4,53270,50.8,17688,17688,9984,56.4,34091,34091,22731,66.7
53037,37944,37944,23046,60.7,22861,60.2,21497,56.7,1364,3.6,185,0.5,14898,39.3,22861,22861,(X),6.0,19015,19015,10850,57.1,10768,56.6,10078,53.0,2463,2463,1543,62.6,4984,4984,3409,68.4
53039,17681,17681,8877,50.2,8877,50.2,8329,47.1,548,3.1,0,0.0,8804,49.8,8877,8877,(X),6.2,8814,8814,3892,44.2,3892,44.2,3706,42.0,1300,1300,901,69.3,2681,2681,1924,71.8
53041,62358,62358,33192,53.2,33136,53.1,30414,48.8,2722,4.4,56,0.1,29166,46.8,33136,33136,(X),8.2,31361,31361,15259,48.7,15259,48.7,13982,44.6,4827,4827,2978,61.7,10429,10429,7253,69.5
53043,8513,8513,4349,51.1,4349,51.1,4160,48.9,189,2.2,0,0.0,4164,48.9,4349,4349,(X),4.3,4157,4157,2026,48.7,2026,48.7,1926,46.3,579,579,248,42.8,1556,1556,1058,68.0
53045,51963,51963,26159,50.3,26019,50.1,24072,46.3,1947,3.7,140,0.3,25804,49.7,26019,26019,(X),7.5,25255,25255,11798,46.7,11798,46.7,11090,43.9,3791,3791,2042,53.9,7577,7577,4984,65.8
53047,33122,33122,18171,54.9,18104,54.7,16954,51.2,1150,3.5,67,0.2,14951,45.1,18104,18104,(X),6.4,16491,16491,8763,53.1,8763,53.1,8341,50.6,2871,2871,1785,62.2,5925,5925,4116,69.5
53049,18164,18164,7580,41.7,7522,41.4,7012,38.6,510,2.8,58,0.3,10584,58.3,7522,7522,(X),6.8,9082,9082,3510,38.6,3499,38.5,3341,36.8,999,999,624,62.5,2279,2279,1384,60.7
53051,10987,10987,4953,45.1,4953,45.1,4654,42.4,299,2.7,0,0.0,6034,54.9,4953,4953,(X),6.0,5436,5436,2390,44.0,2390,44.0,2210,40.7,670,670,468,69.9,1812,1812,1165,64.3
53053,677697,677697,437678,64.6,421669,62.2,397125,58.6,24544,3.6,16009,2.4,240019,35.4,421669,421669,(X),5.8,343329,343329,199652,58.2,197591,57.6,187169,54.5,67186,67186,38742,57.7,127023,127023,85385,67.2
53055,14521,14521,7901,54.4,7896,54.4,7657,52.7,239,1.6,5,0.0,6620,45.6,7896,7896,(X),3.0,7517,7517,3816,50.8,3816,50.8,3706,49.3,570,570,313,54.9,1484,1484,1079,72.7
53057,99600,99600,59381,59.6,58907,59.1,55506,55.7,3401,3.4,474,0.5,40219,40.4,58907,58907,(X),5.8,50484,50484,26886,53.3,26821,53.1,25441,50.4,8304,8304,5038,60.7,17371,17371,12042,69.3
53059,9653,9653,5424,56.2,5422,56.2,5162,53.5,260,2.7,2,0.0,4229,43.8,5422,5422,(X),4.8,4811,4811,2561,53.2,2561,53.2,2408,50.1,604,604,323,53.5,1468,1468,1120,76.3
53061,627302,627302,424425,67.7,420918,67.1,401702,64.0,19216,3.1,3507,0.6,202877,32.3,420918,420918,(X),4.6,314544,314544,193371,61.5,192877,61.3,183673,58.4,57796,57796,34873,60.3,114995,114995,81140,70.6
53063,399212,399212,243921,61.1,241199,60.4,227651,57.0,13548,3.4,2722,0.7,155291,38.9,241199,241199,(X),5.6,202875,202875,116187,57.3,115874,57.1,109571,54.0,35742,35742,20874,58.4,70839,70839,49955,70.5
53065,35676,35676,17556,49.2,17529,49.1,16351,45.8,1178,3.3,27,0.1,18120,50.8,17529,17529,(X),6.7,18145,18145,7794,43.0,7794,43.0,7334,40.4,2682,2682,1186,44.2,6167,6167,3193,51.8
53067,222075,222075,139804,63.0,135904,61.2,126581,57.0,9323,4.2,3900,1.8,82271,37.0,135904,135904,(X),6.9,114697,114697,67019,58.4,66549,58.0,62109,54.2,18993,18993,10377,54.6,38177,38177,26722,70.0
53069,3613,3613,1460,40.4,1460,40.4,1383,38.3,77,2.1,0,0.0,2153,59.6,1460,1460,(X),5.3,1863,1863,717,38.5,717,38.5,687,36.9,145,145,60,41.4,472,472,355,75.2
53071,48783,48783,28155,57.7,28132,57.7,26674,54.7,1458,3.0,23,0.0,20628,42.3,28132,28132,(X),5.2,23937,23937,13561,56.7,13561,56.7,12750,53.3,3659,3659,2203,60.2,8581,8581,6180,72.0
53073,178886,178886,112346,62.8,112112,62.7,105049,58.7,7063,3.9,234,0.1,66540,37.2,112112,112112,(X),6.3,91093,91093,52558,57.7,52557,57.7,49705,54.6,13512,13512,8412,62.3,27249,27249,17900,65.7
53075,42093,42093,24807,58.9,24770,58.8,22539,53.5,2231,5.3,37,0.1,17286,41.1,24770,24770,(X),9.0,20824,20824,11536,55.4,11515,55.3,10578,50.8,2482,2482,1398,56.3,4605,4605,3356,72.9
53077,182459,182459,112461,61.6,112196,61.5,104784,57.4,7412,4.1,265,0.1,69998,38.4,112196,112196,(X),6.6,91885,91885,51596,56.2,51556,56.1,48214,52.5,22599,22599,15476,68.5,48378,48378,34135,70.6
54001,13749,13749,7067,51.4,7067,51.4,6500,47.3,567,4.1,0,0.0,6682,48.6,7067,7067,(X),8.0,7193,7193,3533,49.1,3533,49.1,3257,45.3,874,874,581,66.5,2142,2142,1348,62.9
54003,89435,89435,58168,65.0,57921,64.8,53940,60.3,3981,4.5,247,0.3,31267,35.0,57921,57921,(X),6.9,45702,45702,27785,60.8,27691,60.6,25889,56.6,7971,7971,5310,66.6,17594,17594,13118,74.6
54005,18435,18435,7383,40.0,7383,40.0,6691,36.3,692,3.8,0,0.0,11052,60.0,7383,7383,(X),9.4,9342,9342,3296,35.3,3296,35.3,3063,32.8,1272,1272,442,34.7,3185,3185,1273,40.0
54007,11830,11830,6266,53.0,6266,53.0,5398,45.6,868,7.3,0,0.0,5564,47.0,6266,6266,(X),13.9,5979,5979,2767,46.3,2767,46.3,2411,40.3,854,854,493,57.7,1596,1596,1012,63.4
54009,19149,19149,10567,55.2,10511,54.9,10189,53.2,322,1.7,56,0.3,8582,44.8,10511,10511,(X),3.1,9850,9850,4906,49.8,4890,49.6,4785,48.6,1018,1018,589,57.9,2575,2575,1771,68.8
54011,78196,78196,41130,52.6,41062,52.5,38865,49.7,2197,2.8,68,0.1,37066,47.4,41062,41062,(X),5.4,40395,40395,19724,48.8,19724,48.8,18765,46.5,5910,5910,3724,63.0,11175,11175,7162,64.1
54013,6089,6089,2600,42.7,2600,42.7,2203,36.2,397,6.5,0,0.0,3489,57.3,2600,2600,(X),15.3,3038,3038,1152,37.9,1152,37.9,983,32.4,433,433,279,64.4,898,898,528,58.8
54015,7027,7027,2830,40.3,2830,40.3,2600,37.0,230,3.3,0,0.0,4197,59.7,2830,2830,(X),8.1,3540,3540,1240,35.0,1240,35.0,1150,32.5,511,511,276,54.0,1266,1266,568,44.9
54017,7276,7276,3096,42.6,3096,42.6,2941,40.4,155,2.1,0,0.0,4180,57.4,3096,3096,(X),5.0,3221,3221,1332,41.4,1332,41.4,1256,39.0,380,380,146,38.4,782,782,453,57.9
54019,36120,36120,17121,47.4,17121,47.4,15861,43.9,1260,3.5,0,0.0,18999,52.6,17121,17121,(X),7.4,18011,18011,7739,43.0,7739,43.0,7236,40.2,2707,2707,1678,62.0,5363,5363,3328,62.1
54021,7145,7145,2941,41.2,2941,41.2,2659,37.2,282,3.9,0,0.0,4204,58.8,2941,2941,(X),9.6,2971,2971,1495,50.3,1495,50.3,1319,44.4,380,380,318,83.7,780,780,635,81.4
54023,9702,9702,5158,53.2,5158,53.2,4897,50.5,261,2.7,0,0.0,4544,46.8,5158,5158,(X),5.1,4852,4852,2364,48.7,2364,48.7,2279,47.0,640,640,527,82.3,1501,1501,1086,72.4
54025,29135,29135,14652,50.3,14648,50.3,13667,46.9,981,3.4,4,0.0,14483,49.7,14648,14648,(X),6.7,14988,14988,7002,46.7,6998,46.7,6741,45.0,2059,2059,1263,61.3,4417,4417,2882,65.2
54027,19541,19541,9525,48.7,9525,48.7,9021,46.2,504,2.6,0,0.0,10016,51.3,9525,9525,(X),5.3,9629,9629,4148,43.1,4148,43.1,3944,41.0,1289,1289,545,42.3,2782,2782,1736,62.4
54029,24549,24549,14412,58.7,14412,58.7,13388,54.5,1024,4.2,0,0.0,10137,41.3,14412,14412,(X),7.1,12834,12834,7007,54.6,7007,54.6,6595,51.4,1753,1753,978,55.8,3671,3671,2885,78.6
54031,11268,11268,6627,58.8,6627,58.8,6428,57.0,199,1.8,0,0.0,4641,41.2,6627,6627,(X),3.0,5614,5614,3065,54.6,3065,54.6,3007,53.6,836,836,553,66.1,1722,1722,1272,73.9
54033,55160,55160,32157,58.3,32145,58.3,29985,54.4,2160,3.9,12,0.0,23003,41.7,32145,32145,(X),6.7,28595,28595,15090,52.8,15083,52.7,14027,49.1,4150,4150,2878,69.3,9133,9133,6250,68.4
54035,23570,23570,11795,50.0,11795,50.0,11288,47.9,507,2.2,0,0.0,11775,50.0,11795,11795,(X),4.3,12101,12101,5394,44.6,5394,44.6,5227,43.2,1705,1705,922,54.1,4219,4219,2725,64.6
54037,45097,45097,29276,64.9,29228,64.8,27210,60.3,2018,4.5,48,0.1,15821,35.1,29228,29228,(X),6.9,23041,23041,13583,59.0,13564,58.9,12553,54.5,3631,3631,2396,66.0,8446,8446,5747,68.0
54039,152568,152568,84938,55.7,84768,55.6,79515,52.1,5253,3.4,170,0.1,67630,44.3,84768,84768,(X),6.2,79653,79653,41458,52.0,41452,52.0,39419,49.5,11669,11669,7121,61.0,22990,22990,15925,69.3
54041,13132,13132,6789,51.7,6778,51.6,6363,48.5,415,3.2,11,0.1,6343,48.3,6778,6778,(X),6.1,6608,6608,2938,44.5,2938,44.5,2722,41.2,1292,1292,769,59.5,1995,1995,1320,66.2
54043,16804,16804,7359,43.8,7359,43.8,6861,40.8,498,3.0,0,0.0,9445,56.2,7359,7359,(X),6.8,8487,8487,3483,41.0,3483,41.0,3334,39.3,1458,1458,611,41.9,2824,2824,990,35.1
54045,27660,27660,11936,43.2,11936,43.2,10356,37.4,1580,5.7,0,0.0,15724,56.8,11936,11936,(X),13.2,14095,14095,5481,38.9,5481,38.9,4751,33.7,2043,2043,1176,57.6,4441,4441,2205,49.7
54047,15687,15687,4433,28.3,4433,28.3,4019,25.6,414,2.6,0,0.0,11254,71.7,4433,4433,(X),9.3,7674,7674,2239,29.2,2239,29.2,2043,26.6,1275,1275,530,41.6,2275,2275,718,31.6
54049,46457,46457,26467,57.0,26450,56.9,24881,53.6,1569,3.4,17,0.0,19990,43.0,26450,26450,(X),5.9,23794,23794,12421,52.2,12421,52.2,11735,49.3,3654,3654,2345,64.2,6755,6755,4614,68.3
54051,25965,25965,13157,50.7,13152,50.7,12509,48.2,643,2.5,5,0.0,12808,49.3,13152,13152,(X),4.9,13040,13040,5959,45.7,5959,45.7,5745,44.1,1757,1757,854,48.6,4009,4009,2195,54.8
54053,22068,22068,9939,45.0,9939,45.0,9341,42.3,598,2.7,0,0.0,12129,55.0,9939,9939,(X),6.0,11643,11643,4553,39.1,4553,39.1,4344,37.3,1856,1856,907,48.9,3410,3410,2199,64.5
54055,49533,49533,24116,48.7,24116,48.7,22660,45.7,1456,2.9,0,0.0,25417,51.3,24116,24116,(X),6.0,26318,26318,12079,45.9,12079,45.9,11473,43.6,3867,3867,2603,67.3,6972,6972,4776,68.5
54057,22491,22491,12348,54.9,12348,54.9,11555,51.4,793,3.5,0,0.0,10143,45.1,12348,12348,(X),6.4,11355,11355,5637,49.6,5637,49.6,5392,47.5,1628,1628,860,52.8,3629,3629,2408,66.4
54059,19915,19915,8261,41.5,8261,41.5,6894,34.6,1367,6.9,0,0.0,11654,58.5,8261,8261,(X),16.5,10418,10418,3745,35.9,3745,35.9,3205,30.8,1729,1729,821,47.5,3425,3425,1706,49.8
54061,89969,89969,53732,59.7,53662,59.6,50112,55.7,3550,3.9,70,0.1,36237,40.3,53662,53662,(X),6.6,43489,43489,24327,55.9,24306,55.9,22650,52.1,6006,6006,3807,63.4,10154,10154,7221,71.1
54063,11073,11073,5576,50.4,5576,50.4,5139,46.4,437,3.9,0,0.0,5497,49.6,5576,5576,(X),7.8,5605,5605,2711,48.4,2711,48.4,2477,44.2,751,751,505,67.2,1791,1791,1423,79.5
54065,14766,14766,8223,55.7,8223,55.7,7516,50.9,707,4.8,0,0.0,6543,44.3,8223,8223,(X),8.6,7555,7555,3652,48.3,3652,48.3,3343,44.2,773,773,590,76.3,2373,2373,1653,69.7
54067,20716,20716,10469,50.5,10469,50.5,9758,47.1,711,3.4,0,0.0,10247,49.5,10469,10469,(X),6.8,10607,10607,4618,43.5,4618,43.5,4356,41.1,1523,1523,881,57.8,3277,3277,1975,60.3
54069,35436,35436,21104,59.6,21092,59.5,20013,56.5,1079,3.0,12,0.0,14332,40.4,21092,21092,(X),5.1,18577,18577,10146,54.6,10146,54.6,9706,52.2,2539,2539,1748,68.8,4816,4816,3478,72.2
54071,5961,5961,3031,50.8,2947,49.4,2805,47.1,142,2.4,84,1.4,2930,49.2,2947,2947,(X),4.8,2911,2911,1331,45.7,1316,45.2,1267,43.5,361,361,251,69.5,861,861,588,68.3
54073,6290,6290,3325,52.9,3325,52.9,3026,48.1,299,4.8,0,0.0,2965,47.1,3325,3325,(X),9.0,2895,2895,1384,47.8,1384,47.8,1309,45.2,444,444,257,57.9,948,948,536,56.5
54075,7209,7209,3637,50.5,3637,50.5,3468,48.1,169,2.3,0,0.0,3572,49.5,3637,3637,(X),4.6,3502,3502,1597,45.6,1597,45.6,1522,43.5,469,469,323,68.9,931,931,663,71.2
54077,28003,28003,14721,52.6,14706,52.5,13494,48.2,1212,4.3,15,0.1,13282,47.4,14706,14706,(X),8.2,13637,13637,6759,49.6,6759,49.6,6313,46.3,2144,2144,1471,68.6,4057,4057,2821,69.5
54079,45524,45524,26895,59.1,26783,58.8,25912,56.9,871,1.9,112,0.2,18629,40.9,26783,26783,(X),3.3,23357,23357,12498,53.5,12466,53.4,12199,52.2,3788,3788,2632,69.5,8470,8470,6373,75.2
54081,62185,62185,31115,50.0,31082,50.0,28669,46.1,2413,3.9,33,0.1,31070,50.0,31082,31082,(X),7.8,31283,31283,14493,46.3,14493,46.3,13677,43.7,4797,4797,3041,63.4,9821,9821,6054,61.6
54083,24061,24061,12136,50.4,12136,50.4,11339,47.1,797,3.3,0,0.0,11925,49.6,12136,12136,(X),6.6,11668,11668,5625,48.2,5625,48.2,5300,45.4,1580,1580,949,60.1,3408,3408,2334,68.5
54085,8174,8174,4041,49.4,4041,49.4,3723,45.5,318,3.9,0,0.0,4133,50.6,4041,4041,(X),7.9,4127,4127,1720,41.7,1720,41.7,1637,39.7,536,536,256,47.8,1254,1254,584,46.6
54087,11409,11409,5022,44.0,5022,44.0,4534,39.7,488,4.3,0,0.0,6387,56.0,5022,5022,(X),9.7,5769,5769,2374,41.2,2374,41.2,2166,37.5,771,771,375,48.6,1890,1890,1059,56.0
54089,11081,11081,4967,44.8,4967,44.8,4473,40.4,494,4.5,0,0.0,6114,55.2,4967,4967,(X),9.9,6065,6065,2357,38.9,2357,38.9,2074,34.2,563,563,363,64.5,1546,1546,903,58.4
54091,13881,13881,7448,53.7,7448,53.7,6842,49.3,606,4.4,0,0.0,6433,46.3,7448,7448,(X),8.1,6979,6979,3477,49.8,3477,49.8,3310,47.4,995,995,630,63.3,2318,2318,1448,62.5
54093,6050,6050,3211,53.1,3211,53.1,3002,49.6,209,3.5,0,0.0,2839,46.9,3211,3211,(X),6.5,2992,2992,1378,46.1,1378,46.1,1322,44.2,358,358,219,61.2,661,661,430,65.1
54095,7377,7377,3414,46.3,3414,46.3,3194,43.3,220,3.0,0,0.0,3963,53.7,3414,3414,(X),6.4,3731,3731,1544,41.4,1544,41.4,1450,38.9,477,477,248,52.0,1122,1122,800,71.3
54097,20129,20129,10720,53.3,10720,53.3,9860,49.0,860,4.3,0,0.0,9409,46.7,10720,10720,(X),8.0,10199,10199,4760,46.7,4760,46.7,4393,43.1,1527,1527,796,52.1,3047,3047,2236,73.4
54099,33179,33179,15002,45.2,14980,45.1,13808,41.6,1172,3.5,22,0.1,18177,54.8,14980,14980,(X),7.8,17122,17122,7345,42.9,7345,42.9,6861,40.1,2483,2483,1299,52.3,5429,5429,3196,58.9
54101,7038,7038,3352,47.6,3352,47.6,2989,42.5,363,5.2,0,0.0,3686,52.4,3352,3352,(X),10.8,3613,3613,1524,42.2,1524,42.2,1354,37.5,532,532,255,47.9,904,904,507,56.1
54103,12840,12840,5932,46.2,5932,46.2,5519,43.0,413,3.2,0,0.0,6908,53.8,5932,5932,(X),7.0,6623,6623,2691,40.6,2691,40.6,2534,38.3,800,800,251,31.4,1960,1960,1200,61.2
54105,4673,4673,2235,47.8,2235,47.8,2106,45.1,129,2.8,0,0.0,2438,52.2,2235,2235,(X),5.8,2330,2330,1037,44.5,1037,44.5,1005,43.1,357,357,205,57.4,833,833,448,53.8
54107,69651,69651,38585,55.4,38516,55.3,36541,52.5,1975,2.8,69,0.1,31066,44.6,38516,38516,(X),5.1,36455,36455,18827,51.6,18827,51.6,18135,49.7,5558,5558,3459,62.2,11360,11360,7480,65.8
54109,17816,17816,7016,39.4,7013,39.4,6088,34.2,925,5.2,3,0.0,10800,60.6,7013,7013,(X),13.2,9104,9104,3126,34.3,3126,34.3,2862,31.4,1232,1232,696,56.5,2738,2738,1398,51.1
55001,17470,17470,8121,46.5,8121,46.5,7517,43.0,604,3.5,0,0.0,9349,53.5,8121,8121,(X),7.4,8034,8034,3786,47.1,3786,47.1,3550,44.2,778,778,433,55.7,1956,1956,1436,73.4
55003,12635,12635,7751,61.3,7751,61.3,7291,57.7,460,3.6,0,0.0,4884,38.7,7751,7751,(X),5.9,6315,6315,3679,58.3,3679,58.3,3470,54.9,1004,1004,743,74.0,2328,2328,1748,75.1
55005,36601,36601,22895,62.6,22882,62.5,22141,60.5,741,2.0,13,0.0,13706,37.4,22882,22882,(X),3.2,18454,18454,10832,58.7,10832,58.7,10476,56.8,2958,2958,2164,73.2,6340,6340,4735,74.7
55007,12684,12684,7376,58.2,7371,58.1,7024,55.4,347,2.7,5,0.0,5308,41.8,7371,7371,(X),4.7,6235,6235,3527,56.6,3524,56.5,3376,54.1,756,756,493,65.2,1736,1736,1240,71.4
55009,204256,204256,141529,69.3,141495,69.3,136550,66.9,4945,2.4,34,0.0,62727,30.7,141495,141495,(X),3.5,103738,103738,67846,65.4,67846,65.4,65456,63.1,20138,20138,15228,75.6,40221,40221,31939,79.4
55011,10812,10812,6993,64.7,6991,64.7,6847,63.3,144,1.3,2,0.0,3819,35.3,6991,6991,(X),2.1,5291,5291,3242,61.3,3240,61.2,3193,60.3,803,803,618,77.0,1828,1828,1491,81.6
55013,12844,12844,6965,54.2,6941,54.0,6596,51.4,345,2.7,24,0.2,5879,45.8,6941,6941,(X),5.0,6345,6345,3369,53.1,3369,53.1,3231,50.9,755,755,573,75.9,1773,1773,1425,80.4
55015,39028,39028,28098,72.0,28098,72.0,27476,70.4,622,1.6,0,0.0,10930,28.0,28098,28098,(X),2.2,19536,19536,13339,68.3,13339,68.3,13047,66.8,3369,3369,2585,76.7,8535,8535,7395,86.6
55017,50817,50817,32700,64.3,32686,64.3,31621,62.2,1065,2.1,14,0.0,18117,35.7,32686,32686,(X),3.3,24334,24334,15207,62.5,15207,62.5,14766,60.7,4140,4140,3255,78.6,9662,9662,7829,81.0
55019,25464,25464,16328,64.1,16328,64.1,15832,62.2,496,1.9,0,0.0,9136,35.9,16328,16328,(X),3.0,12600,12600,7113,56.5,7113,56.5,6936,55.0,3337,3337,1745,52.3,6492,6492,3995,61.5
55021,46008,46008,31626,68.7,31522,68.5,30458,66.2,1064,2.3,104,0.2,14382,31.3,31522,31522,(X),3.4,22516,22516,14722,65.4,14695,65.3,14193,63.0,3468,3468,2519,72.6,8397,8397,6952,82.8
55023,13343,13343,7837,58.7,7836,58.7,7566,56.7,270,2.0,1,0.0,5506,41.3,7836,7836,(X),3.4,6401,6401,3778,59.0,3778,59.0,3651,57.0,963,963,612,63.6,2261,2261,1776,78.5
55025,431911,431911,312672,72.4,312183,72.3,302391,70.0,9792,2.3,489,0.1,119239,27.6,312183,312183,(X),3.1,218841,218841,151176,69.1,151075,69.0,147050,67.2,36565,36565,27830,76.1,70292,70292,56148,79.9
55027,71474,71474,46569,65.2,46552,65.1,44570,62.4,1982,2.8,17,0.0,24905,34.8,46552,46552,(X),4.3,33856,33856,21266,62.8,21255,62.8,20299,60.0,5246,5246,3867,73.7,12104,12104,10147,83.8
55029,23537,23537,14066,59.8,13998,59.5,13445,57.1,553,2.3,68,0.3,9471,40.2,13998,13998,(X),4.0,11973,11973,6456,53.9,6455,53.9,6234,52.1,1208,1208,922,76.3,3204,3204,2478,77.3
55031,35627,35627,22859,64.2,22832,64.1,21862,61.4,970,2.7,27,0.1,12768,35.8,22832,22832,(X),4.2,17835,17835,11283,63.3,11281,63.3,10918,61.2,2541,2541,1940,76.3,5901,5901,4756,80.6
55033,36587,36587,24188,66.1,24180,66.1,23300,63.7,880,2.4,8,0.0,12399,33.9,24180,24180,(X),3.6,18287,18287,11343,62.0,11343,62.0,10950,59.9,2779,2779,2044,73.6,5606,5606,4313,76.9
55035,84320,84320,58190,69.0,58101,68.9,55948,66.4,2153,2.6,89,0.1,26130,31.0,58101,58101,(X),3.7,43173,43173,28864,66.9,28864,66.9,27865,64.5,6967,6967,5247,75.3,13184,13184,10541,80.0
55037,3710,3710,2048,55.2,2048,55.2,1924,51.9,124,3.3,0,0.0,1662,44.8,2048,2048,(X),6.1,1790,1790,952,53.2,952,53.2,925,51.7,194,194,117,60.3,469,469,300,64.0
55039,82623,82623,55542,67.2,55520,67.2,53443,64.7,2077,2.5,22,0.0,27081,32.8,55520,55520,(X),3.7,42297,42297,26446,62.5,26443,62.5,25426,60.1,6796,6796,5100,75.0,14594,14594,12007,82.3
55041,7403,7403,3972,53.7,3972,53.7,3704,50.0,268,3.6,0,0.0,3431,46.3,3972,3972,(X),6.7,3675,3675,1900,51.7,1900,51.7,1775,48.3,566,566,417,73.7,1127,1127,905,80.3
55043,42234,42234,27222,64.5,27213,64.4,26382,62.5,831,2.0,9,0.0,15012,35.5,27213,27213,(X),3.1,20228,20228,12475,61.7,12475,61.7,12198,60.3,3313,3313,2419,73.0,7089,7089,5552,78.3
55045,29482,29482,20812,70.6,20792,70.5,20344,69.0,448,1.5,20,0.1,8670,29.4,20792,20792,(X),2.2,14984,14984,9984,66.6,9982,66.6,9766,65.2,2245,2245,1684,75.0,5745,5745,4672,81.3
55047,15049,15049,9425,62.6,9419,62.6,9154,60.8,265,1.8,6,0.0,5624,37.4,9419,9419,(X),2.8,7520,7520,4381,58.3,4375,58.2,4247,56.5,1259,1259,811,64.4,2855,2855,2016,70.6
55049,18763,18763,12890,68.7,12885,68.7,12469,66.5,416,2.2,5,0.0,5873,31.3,12885,12885,(X),3.2,9357,9357,6079,65.0,6079,65.0,5913,63.2,1590,1590,1274,80.1,3677,3677,3059,83.2
55051,4999,4999,2708,54.2,2708,54.2,2509,50.2,199,4.0,0,0.0,2291,45.8,2708,2708,(X),7.3,2456,2456,1277,52.0,1277,52.0,1218,49.6,184,184,147,79.9,566,566,460,81.3
55053,16496,16496,9968,60.4,9965,60.4,9464,57.4,501,3.0,3,0.0,6528,39.6,9965,9965,(X),5.0,7583,7583,4485,59.1,4485,59.1,4261,56.2,1381,1381,1003,72.6,2800,2800,2167,77.4
55055,68651,68651,47616,69.4,47584,69.3,45835,66.8,1749,2.5,32,0.0,21035,30.6,47584,47584,(X),3.7,34470,34470,22554,65.4,22554,65.4,21838,63.4,4963,4963,3868,77.9,12790,12790,10076,78.8
55057,21711,21711,12714,58.6,12614,58.1,12143,55.9,471,2.2,100,0.5,8997,41.4,12614,12614,(X),3.7,10088,10088,5803,57.5,5784,57.3,5606,55.6,1636,1636,1104,67.5,3410,3410,2464,72.3
55059,133650,133650,90301,67.6,89922,67.3,83794,62.7,6128,4.6,379,0.3,43349,32.4,89922,89922,(X),6.8,67975,67975,43370,63.8,43317,63.7,40465,59.5,11389,11389,8492,74.6,26367,26367,20648,78.3
55061,16446,16446,10896,66.3,10896,66.3,10585,64.4,311,1.9,0,0.0,5550,33.7,10896,10896,(X),2.9,8147,8147,5006,61.4,5006,61.4,4879,59.9,1201,1201,985,82.0,3076,3076,2431,79.0
55063,96841,96841,65327,67.5,65229,67.4,62604,64.6,2625,2.7,98,0.1,31514,32.5,65229,65229,(X),4.0,50324,50324,32097,63.8,32093,63.8,31029,61.7,7189,7189,4873,67.8,15671,15671,12878,82.2
55065,13132,13132,8823,67.2,8821,67.2,8630,65.7,191,1.5,2,0.0,4309,32.8,8821,8821,(X),2.2,6531,6531,4016,61.5,4016,61.5,3911,59.9,1276,1276,897,70.3,2733,2733,2127,77.8
55067,15933,15933,9255,58.1,9255,58.1,8588,53.9,667,4.2,0,0.0,6678,41.9,9255,9255,(X),7.2,7932,7932,4291,54.1,4291,54.1,4001,50.4,1005,1005,774,77.0,2533,2533,1837,72.5
55069,23426,23426,14769,63.0,14769,63.0,14200,60.6,569,2.4,0,0.0,8657,37.0,14769,14769,(X),3.9,11624,11624,6951,59.8,6951,59.8,6721,57.8,1439,1439,1025,71.2,3495,3495,2926,83.7
55071,64966,64966,41892,64.5,41855,64.4,40603,62.5,1252,1.9,37,0.1,23074,35.5,41855,41855,(X),3.0,32801,32801,19446,59.3,19446,59.3,18901,57.6,4766,4766,3652,76.6,10953,10953,8440,77.1
55073,107771,107771,73696,68.4,73683,68.4,71176,66.0,2507,2.3,13,0.0,34075,31.6,73683,73683,(X),3.4,54000,54000,34640,64.1,34640,64.1,33468,62.0,9625,9625,6857,71.2,20210,20210,15828,78.3
55075,33820,33820,19670,58.2,19656,58.1,18712,55.3,944,2.8,14,0.0,14150,41.8,19656,19656,(X),4.8,16909,16909,9289,54.9,9288,54.9,8850,52.3,2081,2081,1313,63.1,5171,5171,3951,76.4
55077,12552,12552,7305,58.2,7302,58.2,6925,55.2,377,3.0,3,0.0,5247,41.8,7302,7302,(X),5.2,6164,6164,3456,56.1,3456,56.1,3289,53.4,892,892,698,78.3,1886,1886,1574,83.5
55078,3318,3318,1725,52.0,1725,52.0,1624,48.9,101,3.0,0,0.0,1593,48.0,1725,1725,(X),5.9,1656,1656,925,55.9,925,55.9,889,53.7,454,454,316,69.6,756,756,530,70.1
55079,747409,747409,489394,65.5,489050,65.4,458805,61.4,30245,4.0,344,0.0,258015,34.5,489050,489050,(X),6.2,391076,391076,245031,62.7,244968,62.6,230599,59.0,76117,76117,55557,73.0,143562,143562,108318,75.5
55081,35224,35224,22658,64.3,22321,63.4,21524,61.1,797,2.3,337,1.0,12566,35.7,22321,22321,(X),3.6,17360,17360,10488,60.4,10396,59.9,10021,57.7,3526,3526,2405,68.2,7446,7446,5347,71.8
55083,30944,30944,19666,63.6,19666,63.6,18968,61.3,698,2.3,0,0.0,11278,36.4,19666,19666,(X),3.5,15193,15193,8968,59.0,8968,59.0,8767,57.7,2033,2033,1559,76.7,5312,5312,4182,78.7
55085,29982,29982,17201,57.4,17182,57.3,16687,55.7,495,1.7,19,0.1,12781,42.6,17182,17182,(X),2.9,15099,15099,8281,54.8,8281,54.8,8122,53.8,1668,1668,1187,71.2,4067,4067,3207,78.9
55087,145721,145721,102438,70.3,102407,70.3,99454,68.2,2953,2.0,31,0.0,43283,29.7,102407,102407,(X),2.9,73648,73648,48406,65.7,48404,65.7,47071,63.9,14115,14115,10366,73.4,28030,28030,22518,80.3
55089,71667,71667,48501,67.7,48482,67.6,47039,65.6,1443,2.0,19,0.0,23166,32.3,48482,48482,(X),3.0,36933,36933,22887,62.0,22881,62.0,22167,60.0,5219,5219,3739,71.6,13324,13324,10228,76.8
55091,5896,5896,3828,64.9,3828,64.9,3730,63.3,98,1.7,0,0.0,2068,35.1,3828,3828,(X),2.6,2917,2917,1837,63.0,1837,63.0,1779,61.0,469,469,330,70.4,1018,1018,823,80.8
55093,33964,33964,24162,71.1,24153,71.1,23534,69.3,619,1.8,9,0.0,9802,28.9,24153,24153,(X),2.6,17259,17259,11951,69.2,11949,69.2,11740,68.0,2404,2404,1962,81.6,5946,5946,4936,83.0
55095,35159,35159,22395,63.7,22392,63.7,21468,61.1,924,2.6,3,0.0,12764,36.3,22392,22392,(X),4.1,17486,17486,10422,59.6,10422,59.6,10001,57.2,2657,2657,1878,70.7,6215,6215,4935,79.4
55097,58322,58322,39310,67.4,39277,67.3,37825,64.9,1452,2.5,33,0.1,19012,32.6,39277,39277,(X),3.7,29156,29156,18745,64.3,18741,64.3,18212,62.5,4141,4141,3130,75.6,9179,9179,7485,81.5
55099,11541,11541,6650,57.6,6650,57.6,6505,56.4,145,1.3,0,0.0,4891,42.4,6650,6650,(X),2.2,5722,5722,3047,53.3,3047,53.3,3012,52.6,542,542,353,65.1,1611,1611,1287,79.9
55101,154976,154976,99431,64.2,99386,64.1,94656,61.1,4730,3.1,45,0.0,55545,35.8,99386,99386,(X),4.8,79095,79095,48352,61.1,48333,61.1,46438,58.7,13835,13835,10310,74.5,30072,30072,23171,77.1
55103,14104,14104,8632,61.2,8632,61.2,8403,59.6,229,1.6,0,0.0,5472,38.8,8632,8632,(X),2.7,7091,7091,4124,58.2,4124,58.2,4011,56.6,1107,1107,733,66.2,2547,2547,1767,69.4
55105,127975,127975,84414,66.0,84371,65.9,79644,62.2,4727,3.7,43,0.0,43561,34.0,84371,84371,(X),5.6,65640,65640,40900,62.3,40889,62.3,38954,59.3,11465,11465,7777,67.8,24510,24510,19081,77.8
55107,11594,11594,6665,57.5,6663,57.5,6409,55.3,254,2.2,2,0.0,4929,42.5,6663,6663,(X),3.8,5764,5764,2955,51.3,2955,51.3,2822,49.0,758,758,435,57.4,1912,1912,1220,63.8
55109,68037,68037,49493,72.7,49376,72.6,48173,70.8,1203,1.8,117,0.2,18544,27.3,49376,49376,(X),2.4,34254,34254,23271,67.9,23243,67.9,22783,66.5,6575,6575,5166,78.6,15423,15423,12949,84.0
55111,50731,50731,35217,69.4,35191,69.4,34048,67.1,1143,2.3,26,0.1,15514,30.6,35191,35191,(X),3.2,25644,25644,16787,65.5,16783,65.4,16208,63.2,4566,4566,3492,76.5,9204,9204,7424,80.7
55113,13461,13461,7662,56.9,7662,56.9,7221,53.6,441,3.3,0,0.0,5799,43.1,7662,7662,(X),5.8,6607,6607,3603,54.5,3603,54.5,3431,51.9,795,795,529,66.5,2101,2101,1701,81.0
55115,33098,33098,20740,62.7,20732,62.6,20214,61.1,518,1.6,8,0.0,12358,37.3,20732,20732,(X),2.5,16630,16630,9906,59.6,9906,59.6,9725,58.5,2585,2585,2031,78.6,5719,5719,4413,77.2
55117,92386,92386,61925,67.0,61892,67.0,59637,64.6,2255,2.4,33,0.0,30461,33.0,61892,61892,(X),3.6,46242,46242,29202,63.2,29202,63.2,27978,60.5,7476,7476,5706,76.3,17452,17452,14432,82.7
55119,16022,16022,10631,66.4,10631,66.4,10235,63.9,396,2.5,0,0.0,5391,33.6,10631,10631,(X),3.7,7824,7824,4854,62.0,4854,62.0,4697,60.0,1364,1364,927,68.0,3354,3354,2639,78.7
55121,22943,22943,15515,67.6,15515,67.6,15051,65.6,464,2.0,0,0.0,7428,32.4,15515,15515,(X),3.0,11321,11321,7111,62.8,7111,62.8,6944,61.3,2331,2331,1683,72.2,4640,4640,3520,75.9
55123,23460,23460,13863,59.1,13860,59.1,13479,57.5,381,1.6,3,0.0,9597,40.9,13860,13860,(X),2.7,11828,11828,6531,55.2,6531,55.2,6371,53.9,2523,2523,1385,54.9,5230,5230,2995,57.3
55125,18418,18418,9907,53.8,9907,53.8,9182,49.9,725,3.9,0,0.0,8511,46.2,9907,9907,(X),7.3,9152,9152,4534,49.5,4534,49.5,4362,47.7,962,962,714,74.2,2370,2370,1964,82.9
55127,83565,83565,56214,67.3,56206,67.3,53838,64.4,2368,2.8,8,0.0,27351,32.7,56206,56206,(X),4.2,42172,42172,26668,63.2,26665,63.2,25581,60.7,6390,6390,4747,74.3,14820,14820,11944,80.6
55129,13000,13000,7292,56.1,7292,56.1,6973,53.6,319,2.5,0,0.0,5708,43.9,7292,7292,(X),4.4,6585,6585,3560,54.1,3560,54.1,3410,51.8,837,837,503,60.1,1994,1994,1527,76.6
55131,108188,108188,75748,70.0,75708,70.0,73521,68.0,2187,2.0,40,0.0,32440,30.0,75708,75708,(X),2.9,54659,54659,35487,64.9,35487,64.9,34702,63.5,8626,8626,6396,74.1,20888,20888,16615,79.5
55133,322843,322843,220480,68.3,220296,68.2,213895,66.3,6401,2.0,184,0.1,102363,31.7,220296,220296,(X),2.9,165811,165811,104342,62.9,104327,62.9,101624,61.3,24903,24903,18548,74.5,60064,60064,47146,78.5
55135,42256,42256,27128,64.2,27126,64.2,26292,62.2,834,2.0,2,0.0,15128,35.8,27126,27126,(X),3.1,20753,20753,12753,61.5,12751,61.4,12387,59.7,2868,2868,2258,78.7,7255,7255,5863,80.8
55137,20185,20185,10903,54.0,10898,54.0,10464,51.8,434,2.2,5,0.0,9282,46.0,10898,10898,(X),4.0,9510,9510,4932,51.9,4927,51.8,4735,49.8,1325,1325,822,62.0,2872,2872,2008,69.9
55139,138852,138852,91021,65.6,90983,65.5,87968,63.4,3015,2.2,38,0.0,47831,34.4,90983,90983,(X),3.3,69169,69169,43315,62.6,43292,62.6,41988,60.7,10985,10985,8068,73.4,22765,22765,17454,76.7
55141,59130,59130,37907,64.1,37896,64.1,36451,61.6,1445,2.4,11,0.0,21223,35.9,37896,37896,(X),3.8,30240,30240,17967,59.4,17967,59.4,17342,57.3,4663,4663,3087,66.2,10520,10520,7974,75.8
56001,32234,32234,22152,68.7,22128,68.6,21168,65.7,960,3.0,24,0.1,10082,31.3,22128,22128,(X),4.3,15521,15521,10422,67.1,10422,67.1,10036,64.7,2340,2340,1270,54.3,3899,3899,3145,80.7
56003,9218,9218,5468,59.3,5458,59.2,5178,56.2,280,3.0,10,0.1,3750,40.7,5458,5458,(X),5.1,4549,4549,2362,51.9,2362,51.9,2281,50.1,878,878,553,63.0,2055,2055,1364,66.4
56005,35745,35745,25905,72.5,25905,72.5,24722,69.2,1183,3.3,0,0.0,9840,27.5,25905,25905,(X),4.6,17054,17054,11152,65.4,11152,65.4,10698,62.7,4512,4512,2686,59.5,8240,8240,6150,74.6
56007,12173,12173,7719,63.4,7716,63.4,7503,61.6,213,1.7,3,0.0,4454,36.6,7716,7716,(X),2.8,5559,5559,3287,59.1,3284,59.1,3192,57.4,1259,1259,730,58.0,2290,2290,1627,71.0
56009,10868,10868,7169,66.0,7169,66.0,6829,62.8,340,3.1,0,0.0,3699,34.0,7169,7169,(X),4.7,5341,5341,3183,59.6,3183,59.6,3021,56.6,1131,1131,932,82.4,2160,2160,1377,63.8
56011,5785,5785,3574,61.8,3570,61.7,3446,59.6,124,2.1,4,0.1,2211,38.2,3570,3570,(X),3.5,2826,2826,1548,54.8,1548,54.8,1464,51.8,636,636,346,54.4,1094,1094,815,74.5
56013,31000,31000,19439,62.7,19422,62.7,18248,58.9,1174,3.8,17,0.1,11561,37.3,19422,19422,(X),6.0,15516,15516,9246,59.6,9246,59.6,8759,56.5,3170,3170,2036,64.2,6039,6039,4551,75.4
56015,10973,10973,6721,61.3,6721,61.3,6258,57.0,463,4.2,0,0.0,4252,38.7,6721,6721,(X),6.9,5191,5191,2861,55.1,2861,55.1,2658,51.2,807,807,613,76.0,1675,1675,1348,80.5
56017,3839,3839,2350,61.2,2350,61.2,2292,59.7,58,1.5,0,0.0,1489,38.8,2350,2350,(X),2.5,1944,1944,1062,54.6,1062,54.6,1031,53.0,280,280,197,70.4,523,523,364,69.6
56019,6735,6735,4509,66.9,4509,66.9,4328,64.3,181,2.7,0,0.0,2226,33.1,4509,4509,(X),4.0,3243,3243,1980,61.1,1980,61.1,1956,60.3,517,517,342,66.2,1316,1316,1119,85.0
56021,77505,77505,52143,67.3,49621,64.0,46993,60.6,2628,3.4,2522,3.3,25362,32.7,49621,49621,(X),5.3,38289,38289,23784,62.1,23363,61.0,22042,57.6,7227,7227,4880,67.5,14501,14501,11375,78.4
56023,14367,14367,9583,66.7,9558,66.5,9134,63.6,424,3.0,25,0.2,4784,33.3,9558,9558,(X),4.4,7078,7078,4401,62.2,4383,61.9,4241,59.9,1499,1499,845,56.4,3404,3404,2639,77.5
56025,63369,63369,43459,68.6,43312,68.3,41314,65.2,1998,3.2,147,0.2,19910,31.4,43312,43312,(X),4.6,31469,31469,20043,63.7,20014,63.6,19424,61.7,6152,6152,4358,70.8,11952,11952,9396,78.6
56027,2086,2086,1047,50.2,1047,50.2,1032,49.5,15,0.7,0,0.0,1039,49.8,1047,1047,(X),1.4,1167,1167,455,39.0,455,39.0,443,38.0,109,109,68,62.4,339,339,187,55.2
56029,23980,23980,15140,63.1,15123,63.1,14615,60.9,508,2.1,17,0.1,8840,36.9,15123,15123,(X),3.4,12293,12293,7429,60.4,7429,60.4,7043,57.3,1688,1688,1120,66.4,4037,4037,2744,68.0
56031,7113,7113,4429,62.3,4425,62.2,4307,60.6,118,1.7,4,0.1,2684,37.7,4425,4425,(X),2.7,3531,3531,1892,53.6,1892,53.6,1839,52.1,534,534,321,60.1,1120,1120,824,73.6
56033,24230,24230,15526,64.1,15491,63.9,15075,62.2,416,1.7,35,0.1,8704,35.9,15491,15491,(X),2.7,12395,12395,7245,58.5,7218,58.2,7113,57.4,1880,1880,1260,67.0,4380,4380,3403,77.7
56035,7812,7812,5720,73.2,5720,73.2,5525,70.7,195,2.5,0,0.0,2092,26.8,5720,5720,(X),3.4,3561,3561,2371,66.6,2371,66.6,2294,64.4,669,669,406,60.7,1549,1549,1276,82.4
56037,33529,33529,23348,69.6,23342,69.6,22129,66.0,1213,3.6,6,0.0,10181,30.4,23342,23342,(X),5.2,16034,16034,9932,61.9,9932,61.9,9422,58.8,3762,3762,1982,52.7,7327,7327,5019,68.5
56039,18983,18983,14527,76.5,14527,76.5,14317,75.4,210,1.1,0,0.0,4456,23.5,14527,14527,(X),1.4,9062,9062,6314,69.7,6314,69.7,6253,69.0,1305,1305,858,65.7,3067,3067,2519,82.1
56041,15176,15176,10157,66.9,10141,66.8,9527,62.8,614,4.0,16,0.1,5019,33.1,10141,10141,(X),6.1,7541,7541,4244,56.3,4244,56.3,4020,53.3,1819,1819,1210,66.5,3996,3996,2712,67.9
56043,6557,6557,4095,62.5,4088,62.3,3835,58.5,253,3.9,7,0.1,2462,37.5,4088,4088,(X),6.2,3199,3199,1740,54.4,1740,54.4,1618,50.6,480,480,253,52.7,1303,1303,890,68.3
56045,5702,5702,3305,58.0,3305,58.0,3188,55.9,117,2.1,0,0.0,2397,42.0,3305,3305,(X),3.5,2722,2722,1400,51.4,1400,51.4,1360,50.0,466,466,250,53.6,1015,1015,800,78.8
72001,14771,14771,6165,41.7,6165,41.7,3795,25.7,2370,16.0,0,0.0,8606,58.3,6165,6165,(X),38.4,7554,7554,2756,36.5,2756,36.5,1720,22.8,1071,1071,678,63.3,2767,2767,1538,55.6
72003,32149,32149,13552,42.2,13522,42.1,11595,36.1,1927,6.0,30,0.1,18597,57.8,13522,13522,(X),14.3,16517,16517,5813,35.2,5783,35.0,4895,29.6,1946,1946,1204,61.9,5024,5024,3275,65.2
72005,44762,44762,17466,39.0,17395,38.9,13851,30.9,3544,7.9,71,0.2,27296,61.0,17395,17395,(X),20.4,23300,23300,7926,34.0,7913,34.0,6070,26.1,2964,2964,1564,52.8,7532,7532,4313,57.3
72007,21717,21717,9291,42.8,9291,42.8,7575,34.9,1716,7.9,0,0.0,12426,57.2,9291,9291,(X),18.5,11320,11320,4232,37.4,4232,37.4,3475,30.7,1369,1369,835,61.0,3868,3868,2412,62.4
72009,19311,19311,7007,36.3,6989,36.2,6613,34.2,376,1.9,18,0.1,12304,63.7,6989,6989,(X),5.4,10132,10132,3239,32.0,3239,32.0,3053,30.1,1279,1279,724,56.6,3203,3203,1628,50.8
72011,22936,22936,9969,43.5,9969,43.5,8679,37.8,1290,5.6,0,0.0,12967,56.5,9969,9969,(X),12.9,12046,12046,4497,37.3,4497,37.3,3782,31.4,1198,1198,1013,84.6,3746,3746,2509,67.0
72013,72712,72712,27917,38.4,27876,38.3,22966,31.6,4910,6.8,41,0.1,44795,61.6,27876,27876,(X),17.6,38463,38463,12955,33.7,12955,33.7,10691,27.8,4585,4585,2236,48.8,11638,11638,6545,56.2
72015,14587,14587,4221,28.9,4221,28.9,3711,25.4,510,3.5,0,0.0,10366,71.1,4221,4221,(X),12.1,7970,7970,2439,30.6,2439,30.6,2186,27.4,1082,1082,407,37.6,2888,2888,1583,54.8
72017,19755,19755,7275,36.8,7275,36.8,5936,30.0,1339,6.8,0,0.0,12480,63.2,7275,7275,(X),18.4,10569,10569,3694,35.0,3694,35.0,3189,30.2,1544,1544,963,62.4,3426,3426,2131,62.2
72019,22970,22970,7546,32.9,7546,32.9,6545,28.5,1001,4.4,0,0.0,15424,67.1,7546,7546,(X),13.3,11772,11772,3385,28.8,3385,28.8,2858,24.3,1961,1961,755,38.5,4378,4378,1898,43.4
72021,153182,153182,76193,49.7,76115,49.7,65692,42.9,10423,6.8,78,0.1,76989,50.3,76115,76115,(X),13.7,82019,82019,37465,45.7,37456,45.7,32551,39.7,9510,9510,6410,67.4,23953,23953,15871,66.3
72023,40766,40766,14199,34.8,14199,34.8,12208,29.9,1991,4.9,0,0.0,26567,65.2,14199,14199,(X),14.0,21684,21684,6444,29.7,6444,29.7,5934,27.4,2454,2454,1161,47.3,6583,6583,3592,54.6
72025,108527,108527,54096,49.8,53983,49.7,46508,42.9,7475,6.9,113,0.1,54431,50.2,53983,53983,(X),13.8,59008,59008,26622,45.1,26567,45.0,23123,39.2,6689,6689,4786,71.6,18868,18868,12616,66.9
72027,26637,26637,10223,38.4,10171,38.2,8543,32.1,1628,6.1,52,0.2,16414,61.6,10171,10171,(X),16.0,14021,14021,4443,31.7,4443,31.7,3629,25.9,1644,1644,670,40.8,4573,4573,2584,56.5
72029,37095,37095,18596,50.1,18540,50.0,14206,38.3,4334,11.7,56,0.2,18499,49.9,18540,18540,(X),23.4,19582,19582,8705,44.5,8677,44.3,6397,32.7,2584,2584,1958,75.8,6760,6760,4839,71.6
72031,131031,131031,70701,54.0,70573,53.9,60147,45.9,10426,8.0,128,0.1,60330,46.0,70573,70573,(X),14.8,72148,72148,35799,49.6,35747,49.5,29891,41.4,8104,8104,6607,81.5,21334,21334,16073,75.3
72033,20251,20251,10453,51.6,10399,51.4,7789,38.5,2610,12.9,54,0.3,9798,48.4,10399,10399,(X),25.1,10850,10850,5180,47.7,5161,47.6,3868,35.6,1584,1584,964,60.9,3460,3460,2355,68.1
72035,36828,36828,15572,42.3,15560,42.3,14176,38.5,1384,3.8,12,0.0,21256,57.7,15560,15560,(X),8.9,19277,19277,7557,39.2,7557,39.2,6890,35.7,2491,2491,1396,56.0,5982,5982,4041,67.6
72037,9819,9819,4012,40.9,4003,40.8,3528,35.9,475,4.8,9,0.1,5807,59.1,4003,4003,(X),11.9,5264,5264,1759,33.4,1759,33.4,1527,29.0,561,561,310,55.3,1612,1612,970,60.2
72039,13856,13856,4230,30.5,4230,30.5,3383,24.4,847,6.1,0,0.0,9626,69.5,4230,4230,(X),20.0,7107,7107,1981,27.9,1981,27.9,1579,22.2,1069,1069,556,52.0,2007,2007,1101,54.9
72041,32835,32835,14753,44.9,14701,44.8,12211,37.2,2490,7.6,52,0.2,18082,55.1,14701,14701,(X),16.9,17063,17063,6892,40.4,6880,40.3,5557,32.6,2466,2466,1762,71.5,5751,5751,3880,67.5
72043,32070,32070,12566,39.2,12566,39.2,11633,36.3,933,2.9,0,0.0,19504,60.8,12566,12566,(X),7.4,16779,16779,5706,34.0,5706,34.0,5283,31.5,2112,2112,1084,51.3,5805,5805,3461,59.6
72045,15911,15911,6386,40.1,6375,40.1,4705,29.6,1670,10.5,11,0.1,9525,59.9,6375,6375,(X),26.2,8102,8102,2904,35.8,2904,35.8,2112,26.1,1119,1119,796,71.1,2647,2647,1769,66.8
72047,27707,27707,11353,41.0,11353,41.0,7925,28.6,3428,12.4,0,0.0,16354,59.0,11353,11353,(X),30.2,14459,14459,5167,35.7,5167,35.7,3622,25.1,2087,2087,1184,56.7,5224,5224,2836,54.3
72049,1077,1077,593,55.1,593,55.1,588,54.6,5,0.5,0,0.0,484,44.9,593,593,(X),0.8,534,534,273,51.1,273,51.1,273,51.1,66,66,55,83.3,176,176,164,93.2
72051,30051,30051,14956,49.8,14855,49.4,11583,38.5,3272,10.9,101,0.3,15095,50.2,14855,14855,(X),22.0,15888,15888,6703,42.2,6703,42.2,5215,32.8,2141,2141,1428,66.7,6084,6084,4233,69.6
72053,26123,26123,13727,52.5,13716,52.5,9827,37.6,3889,14.9,11,0.0,12396,47.5,13716,13716,(X),28.4,14136,14136,7180,50.8,7169,50.7,4983,35.3,1925,1925,1381,71.7,4515,4515,3564,78.9
72054,9737,9737,3908,40.1,3908,40.1,3235,33.2,673,6.9,0,0.0,5829,59.9,3908,3908,(X),17.2,5185,5185,1707,32.9,1707,32.9,1279,24.7,829,829,655,79.0,1659,1659,851,51.3
72055,13699,13699,4912,35.9,4912,35.9,3433,25.1,1479,10.8,0,0.0,8787,64.1,4912,4912,(X),30.1,7206,7206,2213,30.7,2213,30.7,1756,24.4,937,937,469,50.1,2360,2360,1222,51.8
72057,34133,34133,10379,30.4,10379,30.4,9570,28.0,809,2.4,0,0.0,23754,69.6,10379,10379,(X),7.8,17262,17262,4877,28.3,4877,28.3,4530,26.2,2344,2344,892,38.1,6083,6083,2085,34.3
72059,15401,15401,6050,39.3,6050,39.3,4677,30.4,1373,8.9,0,0.0,9351,60.7,6050,6050,(X),22.7,8085,8085,2782,34.4,2782,34.4,2107,26.1,1091,1091,489,44.8,2904,2904,1454,50.1
72061,75021,75021,39677,52.9,39579,52.8,35519,47.3,4060,5.4,98,0.1,35344,47.1,39579,39579,(X),10.3,40086,40086,19125,47.7,19125,47.7,17344,43.3,4350,4350,3101,71.3,10711,10711,8144,76.0
72063,37978,37978,21537,56.7,21537,56.7,18000,47.4,3537,9.3,0,0.0,16441,43.3,21537,21537,(X),16.4,20316,20316,10711,52.7,10711,52.7,8882,43.7,2545,2545,1759,69.1,6801,6801,5738,84.4
72065,33471,33471,13008,38.9,12984,38.8,12069,36.1,915,2.7,24,0.1,20463,61.1,12984,12984,(X),7.0,17575,17575,5751,32.7,5751,32.7,5451,31.0,2120,2120,966,45.6,5612,5612,2695,48.0
72067,13665,13665,6230,45.6,6220,45.5,4781,35.0,1439,10.5,10,0.1,7435,54.4,6220,6220,(X),23.1,7504,7504,3055,40.7,3055,40.7,2278,30.4,691,691,456,66.0,2159,2159,1384,64.1
72069,44297,44297,17095,38.6,17084,38.6,14767,33.3,2317,5.2,11,0.0,27202,61.4,17084,17084,(X),13.6,23701,23701,7851,33.1,7851,33.1,6806,28.7,3035,3035,1998,65.8,7052,7052,3951,56.0
72071,35266,35266,13235,37.5,13223,37.5,10784,30.6,2439,6.9,12,0.0,22031,62.5,13223,13223,(X),18.4,18333,18333,5907,32.2,5907,32.2,4874,26.6,2032,2032,1220,60.0,6055,6055,3813,63.0
72073,12001,12001,4268,35.6,4268,35.6,3322,27.7,946,7.9,0,0.0,7733,64.4,4268,4268,(X),22.2,5943,5943,1878,31.6,1878,31.6,1434,24.1,793,793,422,53.2,2355,2355,1361,57.8
72075,37780,37780,18958,50.2,18927,50.1,14754,39.1,4173,11.0,31,0.1,18822,49.8,18927,18927,(X),22.0,20089,20089,9020,44.9,9018,44.9,6849,34.1,3068,3068,2061,67.2,7069,7069,5200,73.6
72077,31845,31845,15323,48.1,15323,48.1,11179,35.1,4144,13.0,0,0.0,16522,51.9,15323,15323,(X),27.0,16914,16914,7534,44.5,7534,44.5,5483,32.4,2436,2436,1662,68.2,5948,5948,3788,63.7
72079,19541,19541,5846,29.9,5846,29.9,4605,23.6,1241,6.4,0,0.0,13695,70.1,5846,5846,(X),21.2,10115,10115,2433,24.1,2433,24.1,2140,21.2,1174,1174,224,19.1,3037,3037,1627,53.6
72081,21950,21950,9013,41.1,9013,41.1,6446,29.4,2567,11.7,0,0.0,12937,58.9,9013,9013,(X),28.5,11287,11287,4002,35.5,4002,35.5,2497,22.1,1445,1445,915,63.3,3702,3702,2298,62.1
72083,6954,6954,2220,31.9,2220,31.9,2150,30.9,70,1.0,0,0.0,4734,68.1,2220,2220,(X),3.2,3524,3524,897,25.5,897,25.5,866,24.6,534,534,201,37.6,1196,1196,525,43.9
72085,30899,30899,12867,41.6,12856,41.6,10509,34.0,2347,7.6,11,0.0,18032,58.4,12856,12856,(X),18.3,16239,16239,6104,37.6,6104,37.6,4951,30.5,1997,1997,1419,71.1,5765,5765,3392,58.8
72087,21400,21400,10273,48.0,10273,48.0,7500,35.0,2773,13.0,0,0.0,11127,52.0,10273,10273,(X),27.0,11621,11621,5049,43.4,5049,43.4,3659,31.5,1518,1518,1100,72.5,4091,4091,3092,75.6
72089,15290,15290,7537,49.3,7537,49.3,5636,36.9,1901,12.4,0,0.0,7753,50.7,7537,7537,(X),25.2,8241,8241,3504,42.5,3504,42.5,2540,30.8,962,962,666,69.2,2509,2509,1669,66.5
72091,32527,32527,13263,40.8,13263,40.8,10984,33.8,2279,7.0,0,0.0,19264,59.2,13263,13263,(X),17.2,17575,17575,6249,35.6,6249,35.6,4847,27.6,2407,2407,1348,56.0,5598,5598,3436,61.4
72093,5130,5130,1510,29.4,1510,29.4,1321,25.8,189,3.7,0,0.0,3620,70.6,1510,1510,(X),12.5,2583,2583,474,18.4,474,18.4,379,14.7,279,279,157,56.3,792,792,274,34.6
72095,9142,9142,3049,33.4,3049,33.4,2227,24.4,822,9.0,0,0.0,6093,66.6,3049,3049,(X),27.0,4663,4663,1424,30.5,1424,30.5,1050,22.5,616,616,541,87.8,1419,1419,966,68.1
72097,65310,65310,25725,39.4,25672,39.3,18782,28.8,6890,10.5,53,0.1,39585,60.6,25672,25672,(X),26.8,34508,34508,12113,35.1,12113,35.1,8853,25.7,3778,3778,2283,60.4,9135,9135,5687,62.3
72099,29994,29994,12258,40.9,12228,40.8,8993,30.0,3235,10.8,30,0.1,17736,59.1,12228,12228,(X),26.5,15438,15438,5606,36.3,5606,36.3,3894,25.2,2104,2104,1108,52.7,5615,5615,3430,61.1
72101,25338,25338,10839,42.8,10839,42.8,8586,33.9,2253,8.9,0,0.0,14499,57.2,10839,10839,(X),20.8,12880,12880,4375,34.0,4375,34.0,3394,26.4,1695,1695,941,55.5,4961,4961,3118,62.9
72103,21159,21159,7851,37.1,7851,37.1,7043,33.3,808,3.8,0,0.0,13308,62.9,7851,7851,(X),10.3,11421,11421,3139,27.5,3139,27.5,2867,25.1,1507,1507,822,54.5,4199,4199,2252,53.6
72105,23292,23292,9850,42.3,9850,42.3,7478,32.1,2372,10.2,0,0.0,13442,57.7,9850,9850,(X),24.1,11861,11861,4320,36.4,4320,36.4,3583,30.2,1792,1792,968,54.0,4012,4012,2569,64.0
72107,17442,17442,6700,38.4,6700,38.4,4412,25.3,2288,13.1,0,0.0,10742,61.6,6700,6700,(X),34.1,8774,8774,2896,33.0,2896,33.0,1911,21.8,1242,1242,595,47.9,3289,3289,1652,50.2
72109,14326,14326,4997,34.9,4982,34.8,4027,28.1,955,6.7,15,0.1,9329,65.1,4982,4982,(X),19.2,7379,7379,2450,33.2,2450,33.2,2057,27.9,1030,1030,586,56.9,2232,2232,1122,50.3
72111,16637,16637,6696,40.2,6683,40.2,5089,30.6,1594,9.6,13,0.1,9941,59.8,6683,6683,(X),23.9,8635,8635,3090,35.8,3090,35.8,2468,28.6,1331,1331,635,47.7,3397,3397,2183,64.3
72113,117870,117870,44534,37.8,44474,37.7,38169,32.4,6305,5.3,60,0.1,73336,62.2,44474,44474,(X),14.2,61838,61838,20941,33.9,20941,33.9,18305,29.6,9098,9098,4438,48.8,19694,19694,10412,52.9
72115,19760,19760,7709,39.0,7709,39.0,6797,34.4,912,4.6,0,0.0,12051,61.0,7709,7709,(X),11.8,10274,10274,3282,31.9,3282,31.9,2931,28.5,1246,1246,611,49.0,3569,3569,1905,53.4
72117,12026,12026,5059,42.1,5045,42.0,4548,37.8,497,4.1,14,0.1,6967,57.9,5045,5045,(X),9.9,6330,6330,2213,35.0,2213,35.0,2090,33.0,700,700,510,72.9,1886,1886,1126,59.7
72119,41955,41955,21642,51.6,21642,51.6,16592,39.5,5050,12.0,0,0.0,20313,48.4,21642,21642,(X),23.3,21999,21999,10706,48.7,10706,48.7,8008,36.4,2766,2766,2207,79.8,7075,7075,5148,72.8
72121,19044,19044,6919,36.3,6919,36.3,5712,30.0,1207,6.3,0,0.0,12125,63.7,6919,6919,(X),17.4,10261,10261,3403,33.2,3403,33.2,2922,28.5,1178,1178,739,62.7,3358,3358,2092,62.3
72123,23065,23065,8753,37.9,8686,37.7,7949,34.5,737,3.2,67,0.3,14312,62.1,8686,8686,(X),8.5,12182,12182,3957,32.5,3957,32.5,3679,30.2,1770,1770,927,52.4,4590,4590,2485,54.1
72125,26709,26709,8936,33.5,8936,33.5,8257,30.9,679,2.5,0,0.0,17773,66.5,8936,8936,(X),7.6,13929,13929,4253,30.5,4253,30.5,3874,27.8,1950,1950,947,48.6,3936,3936,2127,54.0
72127,288699,288699,148948,51.6,148801,51.5,125905,43.6,22896,7.9,147,0.1,139751,48.4,148801,148801,(X),15.4,159288,159288,73559,46.2,73512,46.2,61786,38.8,19129,19129,12284,64.2,43088,43088,29159,67.7
72129,31129,31129,12516,40.2,12516,40.2,11355,36.5,1161,3.7,0,0.0,18613,59.8,12516,12516,(X),9.3,16064,16064,5723,35.6,5723,35.6,5116,31.8,2013,2013,1135,56.4,5055,5055,3165,62.6
72131,31318,31318,11626,37.1,11626,37.1,8619,27.5,3007,9.6,0,0.0,19692,62.9,11626,11626,(X),25.9,16308,16308,5222,32.0,5222,32.0,3701,22.7,1929,1929,818,42.4,5534,5534,3081,55.7
72133,17672,17672,8378,47.4,8378,47.4,7671,43.4,707,4.0,0,0.0,9294,52.6,8378,8378,(X),8.4,9226,9226,3960,42.9,3960,42.9,3469,37.6,1253,1253,788,62.9,3697,3697,2182,59.0
72135,59877,59877,30795,51.4,30757,51.4,27034,45.1,3723,6.2,38,0.1,29082,48.6,30757,30757,(X),12.1,31613,31613,15148,47.9,15148,47.9,13620,43.1,4048,4048,2729,67.4,11410,11410,7650,67.0
72137,65614,65614,34197,52.1,34153,52.1,28173,42.9,5980,9.1,44,0.1,31417,47.9,34153,34153,(X),17.5,35374,35374,16820,47.5,16805,47.5,13893,39.3,4551,4551,3258,71.6,11292,11292,7590,67.2
72139,55696,55696,29143,52.3,29133,52.3,27167,48.8,1966,3.5,10,0.0,26553,47.7,29133,29133,(X),6.7,30172,30172,14128,46.8,14128,46.8,13197,43.7,3725,3725,2574,69.1,9876,9876,6841,69.3
72141,24206,24206,9270,38.3,9270,38.3,6547,27.0,2723,11.2,0,0.0,14936,61.7,9270,9270,(X),29.4,12589,12589,4468,35.5,4468,35.5,2966,23.6,1529,1529,956,62.5,4215,4215,2532,60.1
72143,30407,30407,12323,40.5,12323,40.5,9815,32.3,2508,8.2,0,0.0,18084,59.5,12323,12323,(X),20.4,16150,16150,5471,33.9,5471,33.9,4429,27.4,2159,2159,1277,59.1,5810,5810,3673,63.2
72145,43815,43815,17633,40.2,17633,40.2,14314,32.7,3319,7.6,0,0.0,26182,59.8,17633,17633,(X),18.8,23176,23176,8941,38.6,8941,38.6,7277,31.4,2783,2783,1676,60.2,7684,7684,4618,60.1
72147,7042,7042,2922,41.5,2922,41.5,2487,35.3,435,6.2,0,0.0,4120,58.5,2922,2922,(X),14.9,3529,3529,1196,33.9,1196,33.9,969,27.5,580,580,328,56.6,1077,1077,707,65.6
72149,18663,18663,8608,46.1,8581,46.0,6625,35.5,1956,10.5,27,0.1,10055,53.9,8581,8581,(X),22.8,9710,9710,3900,40.2,3898,40.1,2959,30.5,1531,1531,907,59.2,3428,3428,1973,57.6
72151,28146,28146,10884,38.7,10853,38.6,8044,28.6,2809,10.0,31,0.1,17262,61.3,10853,10853,(X),25.9,14601,14601,5063,34.7,5063,34.7,3821,26.2,1571,1571,1030,65.6,4749,4749,2816,59.3
72153,30226,30226,11146,36.9,11146,36.9,8924,29.5,2222,7.4,0,0.0,19080,63.1,11146,11146,(X),19.9,15982,15982,4681,29.3,4681,29.3,3826,23.9,2048,2048,976,47.7,4736,4736,2226,47.0
